Project.Number,County,System.Name,Borrower,Description,Pop,Project.Cost,Score,Cumulative.Total
17299,Albany,RAVENA VILLAGE,Ravena (V),"Source, WTP, Storage, and Distribution Improvements., Upgrade Water Treatment Plant, Upgrade Surface Water Source, Upgrade Storage, Upgrade Distribution System",4500,0,1080,0
18535,Albany,WATERVLIET CITY,Watervliet (C),"Water System Improvements., Upgrade Water Treatment Plant, Upgrade Transmission",9889,0,80,0
18903,Albany,ALBANY CITY,Albany MWFA,"2022 Water System Improvements., Upgrade Water Treatment Plant, Upgrade Storage, Upgrade Pump Station",101082,0,70,0
18523,Albany,ALBANY CITY,Albany MWFA,"Feura Bush WTP Upgrades., Upgrade Water Treatment Plant, Upgrade Storage",101082,0,65,0
17548,Albany,MENANDS VILLAGE,Menands (V),"Upgrade Pump Station, Upgrade Distribution System",3900,6936000,60,6936000
18659,Albany,WESTERLO WD 1,Westerlo (T),"Aeration for DBP treatment at well sources, Upgrade Water Treatment Plant",265,200000,55,7136000
18984,Albany,COHOES CITY,Cohoes (C),"Phase 2 WTP Upgrades., Upgrade Water Treatment Plant",15550,9738811,45,16874811
18572,Albany,COHOES CITY,Cohoes (C),"WTP Improvements Phase I., Upgrade Water Treatment Plant",15550,9609256,45,26484067
19155,Albany,RAVENA (V),Ravena (V),"Phase 2 Water System Improvements, Upgrade Water Treatment Plant, Upgrade Storage, Upgrade Pump Station, Upgrade Distribution System",3500,7650840,40,34134907
19558,Albany,ALBANY (C),Albany MWFA,"Rensselaer Lake Dam Safety Improvements, Upgrade Other Expenses, Upgrade Other (OT)",98000,1954888,40,36089795
19127,Albany,ALBANY (C),Albany MWFA,"Basic Creek Reservoir Dam Safety Improvements, Upgrade Surface Water Source",101082,7822850,40,43912645
19157,Albany,ALBANY (C),Albany MWFA,"Water System Improvements, Upgrade Water Treatment Plant, Upgrade Storage, Upgrade Pump Station",101082,8642193,40,52554838
19456,Albany,ALBANY (C),Albany (C),"Lead service line replacement., Upgrade Distribution System",7725,12864426,40,65419264
18333,Albany,MENANDS VILLAGE,Menands (V),"South End Water System Improvements., Upgrade Distribution System",3900,0,35,65419264
19554,Albany,ALBANY (C),Albany MWFA,"Water main replacement and upgrade of associated appurtenances., Upgrade Distribution System",98617,7604722,35,73023986
19059,Albany,GUILDERLAND (T),Guilderland (T),"Greensand Groundwater Filtration system., Upgrade Water Treatment Plant",27546,5005050,35,78029036
18807,Albany,LATHAM WATER DISTRICT,Colonie (T),"River Road Storage and Mohawk View WTP Mixing Improvements, Upgrade Water Treatment Plant, Upgrade Distribution System",78500,6230000,30,84259036
19443,Albany,RAVENA (V),Ravena (V),"Lead service line inventory., Upgrade Distribution System",3271,345050,25,84604086
19152,Albany,BETHLEHEM WD NO 1 - NEW SALEM SYSTEM,Bethlehem (T),"NYS Route 85 Transmission Main Replacement, Upgrade Transmission",31000,6695000,20,91299086
19341,Albany,BETHLEHEM WD NO 1 - NEW SALEM SYSTEM,Bethlehem (T),"Rehabilitation of 3.0 MG Storage Tank, Upgrade Storage",31000,2500000,15,93799086
19150,Albany,BETHLEHEM WD NO 1 - NEW SALEM SYSTEM,Bethlehem (T),"Elevated Water Storage Tank Replacement, Upgrade Storage",31000,3900000,15,97699086
18824,Allegany,HUME WATER DISTRICT,Hume (T),"Sanford Springs Consolidation and System Upgrades., Extend Distribution System, Upgrade Distribution System, New System Consolidation",620,600000,1160,98299086
18358,Allegany,ANDOVER (V),Andover (V),"Source (GWUDI Springs), Distribution, & Storage Improvements., New Water Treatment Plant, Upgrade Transmission, Upgrade Distribution System, New System Consolidation",2500,2547345,1135,100846431
19051,Allegany,SCIO WATER DISTRICT,Scio (T),"Water Storage Tank Replacement and Water System Improvements, Upgrade Storage, Upgrade Distribution System",900,2550000,90,103396431
18896,Allegany,CUBA (V),Cuba (V),"Water main replacement and improvements to well site and storage tanks., Upgrade Ground Water Source, Upgrade Storage, Upgrade Distribution System",1500,7373770,60,110770201
19213,Allegany,WELLSVILLE (V),Wellsville (V),"Village-Wide Watermain Replacement, Upgrade Distribution System",900,5166480,60,115936681
18622,Allegany,ALFRED VILLAGE WATER SUPPLY,Alfred (V),"Upgrade Transmission, Upgrade Storage, Upgrade Pump Station, Upgrade Distribution System",3500,0,55,115936681
18856,Allegany,WELLSVILLE VILLAGE PUBLIC WATER,Wellsville (V),"Replacement of WTP pumps and controls, meters, and aged water mains., Upgrade Water Treatment Plant, Upgrade Distribution System",5700,1596912,55,117533593
19552,Allegany,FRIENDSHIP (T),Friendship (T),"Distribution, Source and Treatment Upgrades, Upgrade Ground Water Source, Upgrade Distribution System",1400,12450000,45,129983593
19531,Allegany,ANGELICA (V),Angelica (V),"Replacement of WM and New Water District, Upgrade Distribution System",713,3932160,40,133915753
19551,Allegany,ALMOND (V),Almond (V),"Mill St. & Maple Ridge Water Main Improvements Project, Upgrade Distribution System",690,1025000,25,134940753
18369,Allegany,ALMOND VILLAGE PUBLIC WATER,Almond (V),"Upgrade Water Treatment Plant, Upgrade Storage, Upgrade Distribution System",600,922000,20,135862753
18941,Broome,VILLAGE OF ENDICOTT,Endicott (V),"New Source Development to Address Fe/Mn/1,4-dioxane., New Ground Water Source",46000,7310218,120,143172971
18681,Broome,ENDICOTT (V),Endicott (V),"Well No. 32 treatment for iron, manganese, and 1,4-dioxane., Upgrade Water Treatment Plant",46000,18473853,80,161646824
18544,Broome,PORT DICKINSON (V),Port Dickinson (V),"Replace Aged Water Mains Chenango St. and Rochelle Rd., Upgrade Distribution System",1699,2810116,45,164456940
18576,Broome,"BINGHAMTON, CITY OF",Binghamton (C),"Harding Avenue Water Tank Replacement., Upgrade Storage",47600,1273080,40,165730020
18610,Broome,VESTAL CONSOLIDATED W.D. #1,Vestal (T),"Old Vestal & Burn Hill Rd Watermain., Upgrade Distribution System",20950,1652683,35,167382703
18256,Broome,CHENANGO CONSOLIDATED WD #1,Chenango (T),"New well and appurtenances as redundancy for Northgate Well., New Ground Water Source",9200,2519195,30,169901898
18748,Broome,BINGHAMTON (T) CONSOLIDATED WD,Binghamton (T),"Powers Road Storage Tank Replacement., New Storage",2600,939393,25,170841291
18842,Cattaraugus,SOUTH DAYTON VILLAGE,South Dayton (V),"Source and distribution upgrades., Upgrade Ground Water Source, Upgrade Distribution System",661,0,1120,170841291
18574,Cattaraugus,ELLICOTTVILLE (T) & (V),Ellicottville (T),"Upgrade Wells, Pump Stations, and Storage., Upgrade Ground Water Source, Upgrade Storage, Upgrade Pump Station",900,0,1100,170841291
18907,Cattaraugus,LITTLE VALLEY VILLAGE,Little Valley (V),"Installation of wells, main replacement, and WTP improvements., Upgrade Water Treatment Plant, New Ground Water Source, Upgrade Distribution System",1188,5950000,135,176791291
19244,Cattaraugus,SALAMANCA (C),Salamanca (C),"Abandon Existing WTP, New Well Source, New Pump Building., Upgrade Water Treatment Plant",6150,28040556,90,204831847
18843,Cattaraugus,PORTVILLE VILLAGE,Portville (V),"Well, treatment, storage, and distribution upgrades., Upgrade Water Treatment Plant, Upgrade Ground Water Source, Upgrade Storage, Upgrade Distribution System",1040,5408530,85,210240377
18813,Cattaraugus,FRANKLINVILLE VILLAGE,Franklinville (V),"South and North Wellhouse Improvements & Howard Street Water Main Replacement., Upgrade Ground Water Source, Upgrade Distribution System",1760,6000000,60,216240377
19026,Cattaraugus,OLEAN (C),Olean (C),"WTP Upgrades and Structural Rehabilitation, Upgrade Water Treatment Plant",13937,4801500,45,221041877
18025,Cattaraugus,SALAMANCA CITY,Salamanca (C),Upgrade Distribution System,7000,1688000,30,222729877
19060,Cattaraugus,ALLEGANY VILLAGE,Allegany (V),"2021 Water Meter Upgrades, Upgrade Other Expenses, Upgrade Other (OT)",1900,163915,25,222893792
19201,Cayuga,CAYUGA COUNTY W&S AUTHORITY,Cayuga County W&S Authority,"Regional Water District Project, New Water Treatment Plant, Upgrade Transmission, New Storage, New Pump Station, Upgrade Distribution System, New System Consolidation, New Water District",42653,54882970,125,277776762
18564,Cayuga,AURORA (V) NEW SYSTEM,Aurora (V),"New WTP, New Transmission, New Inter-Connection",700,10370000,105,288146762
18128,Cayuga,PROPOSED WD #2,Sterling (T),"Water District #2., Extend Distribution System",500,6669393,80,294816155
19411,Cayuga,AUBURN (C),Auburn (C),"Lead Service Line Inventory., Upgrade Distribution System",43000,917988,70,295734142
18905,Cayuga,AUBURN,Auburn (C),"Comprehensive upgrades to City of Auburn Water Filtration Plant, Upgrade Water Treatment Plant",29788,9866370,70,305600512
19133,Cayuga,WEEDSPORT (V),Weedsport (V),"Water Systems Improvements, Upgrade Storage, Upgrade Distribution System",1945,22008000,55,327608512
19074,Cayuga,WD NO. 11,Brutus (T),"Water District No. 11, New Water District",116,1430000,50,329038512
19073,Cayuga,WD NO. 10,Brutus (T),"Water District No. 10, New Water District",90,1100000,50,330138512
18924,Cayuga,"CCWSA PHASE 1A:AUR, FLEM, SPRING",Cayuga County W&S Authority,"Main extension on Honoco Rd., New Distribution System",180,7130744,50,337269256
19199,Cayuga,THROOP (T) WD #2,Throop (T),"Water District #2 - Centerport, Reyer, and Sine Rd., New Water District",66,1069400,45,338338656
18182,Cayuga,SENNETT WD #6,Sennett (T),"Upgrade Other Expenses, Upgrade Storage, Upgrade Distribution System, Upgrade Other (OT)",60,4142100,40,342480756
19210,Cayuga,AUBURN,Auburn (C),"Raw Water Transmission Main Replacement, Upgrade Transmission",29788,12300000,40,354780756
19191,Cayuga,LOCKE W D,Locke (T),"New storage tank and well & Telemetry Upgrades at all facilities, New Ground Water Source, New Storage",600,3416049,40,358196805
19398,Cayuga,WEEDSPORT (V),Weedsport (V),"Lead Service Line Inventory., Upgrade Distribution System",1945,606500,35,358803305
18436,Cayuga,NILES WD NO. 1,Niles (T),"Niles Water District No. 1. , New Water District",33,201762,30,359005067
19209,Cayuga,FAIR HAVEN VILLAGE,Fair Haven (V),"Replacement of Asbestos Cement Watermain, Upgrade Distribution System",1000,5892888,25,364897955
18401,Cayuga,FLEMING WD #1,Fleming (T),"WD #1 Phase IIA Distribution Improvements., Upgrade Distribution System",1800,654000,15,365551955
18520,Chautauqua,MAYVILLE VILLAGE,Mayville (V),"New Source Development, Storage and Distribution Upgrades., Upgrade Other Expenses, New Ground Water Source, New Storage, Upgrade Distribution System, Upgrade Other (OT)",1856,500000,1170,366051955
18826,Chautauqua,SINCLAIRVILLE VILLAGE,Sinclairville (V),"Phase 2 of Project #18105., Upgrade Ground Water Source, Upgrade Transmission, Extend Distribution System",772,0,1145,366051955
18806,Chautauqua,SHERMAN VILLAGE,Sherman (V),"Upgrade Water Treatment Plant, Upgrade Ground Water Source, Upgrade Storage, Upgrade Distribution System",917,0,1110,366051955
19529,Chautauqua,MAYVILLE (V),Mayville (V),"New Well, New Treatment System, Replace WM, New Ground Water Source",2000,7640540,105,373692495
19525,Chautauqua,CLYMER (T),Clymer (T),"New Well, New Storage Tank, and Replacement of WM, New Ground Water Source",545,10707880,95,384400375
18772,Chautauqua,CHAUTAUQUA HEIGHTS WATER DISTRICT,Chautauqua (T),"WD No. 2 Alternative Water Supply., New Ground Water Source",174,6942000,95,391342375
19538,Chautauqua,CHAUTAUQUA (T),Chautauqua (T),"Extension of WD No. 4, Upgrade Water District",650,9591360,95,400933735
18321,Chautauqua,NCCRWP,Chautauqua County,"North Chautauqua County Regional Water Project., New Water District",31000,0,70,400933735
19247,Chautauqua,POMFRET (T),Pomfret (T),"North End WD Phase 2, New Distribution System",1200,22263450,65,423197185
18540,Chautauqua,WD 2 EXT 1 NORTH & WTP RELOCATION,Chautauqua (T),"New Surface Water Treatment Rule Compliance Facility, Extend Transmission, Extend Distribution System",230,5125280,65,428322465
19330,Chautauqua,PORTLAND WD #2,Portland (T),"Water District No 2, Rt 5 Water Main Replacement, Upgrade Distribution System",4827,2601000,50,430923465
19308,Chautauqua,SHOREWOOD WATER DISTRICT,Dunkirk (T),"Shorewood Water District Main Replacement, Upgrade Distribution System",700,2295000,40,433218465
18413,Chautauqua,FREWSBURG WATER DISTRICT,Carroll (T),Upgrade Storage,2600,960000,40,434178465
19246,Chautauqua,CHESTNUT ROAD WATER DISTRICT,Pomfret (T),"Chestnut WD Water Main Replacement, Upgrade Distribution System",90,681345,35,434859810
18757,Chautauqua,BROCTON (V),Brocton (V),"Replacement of approximately 3,400 LF of 8"" watermain., Upgrade Distribution System",1486,0,35,434859810
19245,Chautauqua,BERRY ROAD WATER DISTRICT,Pomfret (T),"Berry WD Water Main Replacement, Upgrade Distribution System",150,1835666,35,436695476
18770,Chautauqua,POMFRET (T),Pomfret (T),"Replacement of distribution mains, and appurtenances in Lily Dale WD., Upgrade Distribution System",3730,3230000,35,439925476
18084,Chautauqua,BROCTON VILLAGE,Brocton (V),"Replace 10,600 lf +/-water main, Upgrade Distribution System",4000,0,35,439925476
19179,Chautauqua,FREDONIA VILLAGE,Fredonia (V),"Fredonia Fresh Water Reservoir Spillway Improvements, Upgrade Surface Water Source",10400,10300000,30,450225476
18399,Chautauqua,CLYMER WATER DISTRICT,Clymer (T),"Repairs to wellhouse floor., Upgrade Ground Water Source",650,275000,25,450500476
18322,Chemung,ELMIRA WATER BOARD,Elmira Water Board,"Elmira Refresh Initiative., Upgrade Transmission, Upgrade Distribution System",65000,6043913,70,456544389
19068,Chemung,HORSEHEADS VILLAGE,Horseheads (T),"Oak Hill Water District Extension, New Distribution System",11530,461000,70,457005389
19149,Chemung,WELLSBURG (V),Wellsburg (V),"Tank decommissioning & replacements, distribution upgrades, new emergency ground supply, New Ground Water Source",580,6536623,60,463542012
18890,Chemung,MILLPORT (V),Millport (V),"New Well and Upgrade Tank, Meters, and Telemetry., New Other Expenses, Upgrade Ground Water Source, Upgrade Storage",292,1604100,60,465146112
18737,Chemung,BIG FLATS WD #4,Big Flats (T),"Smith Valley and Ponderosa Drive Extension., Extend Distribution System",231,2277534,55,467423646
18767,Chemung,HORSEHEADS VILLAGE,Horseheads (V),"Upgrade water mains and appurtenances in Ridge Road, Number Street and Center Street areas., Upgrade Distribution System",11530,0,45,467423646
18309,Chenango,GUILFORD WATER DISTRICT,Guilford (T),"Water System Improvements Project, New Water Treatment Plant, New Ground Water Source, New Transmission",350,0,1075,467423646
18717,Chenango,SOUTH OTSELIC WATER DISTRICT,Otselic (T),"Improvements to Source, treatment, storage, distribution, and meters., Upgrade Ground Water Source, Upgrade Storage, Upgrade Distribution System",300,4259000,105,471682646
18923,Chenango,NEW BERLIN (V),New Berlin (V),"Treatment upgrades, main replacement, new meters and tank improvements., Upgrade Water Treatment Plant, Upgrade Storage, Upgrade Distribution System",1000,15397000,95,487079646
19399,Chenango,SMITHVILLE (T),Smithville (T),"Smithville Flats New Water System, New Ground Water Source",350,8000000,70,495079646
19184,Chenango,BAINBRIDGE (V),Bainbridge (V),"Water System Improvements - WM Replacement, New Well, Booster PS Improvements, New Ground Water Source, Upgrade Pump Station, Upgrade Distribution System",1600,7455600,65,502535246
18198,Chenango,OXFORD VILLAGE,Oxford (V),"Upgrades to valve vault, distribution & transmission mains., Upgrade Transmission, Upgrade Distribution System",1738,0,60,502535246
18522,Chenango,NEW BERLIN VILLAGE,New Berlin (V),"Distribution, source, and storage improvements., Upgrade Ground Water Source, Upgrade Storage, Upgrade Distribution System",1500,4877339,45,507412585
18554,Chenango,AFTON (V),Afton (V),"Replace water storage tank, upgrade spring source booster pump station, upgrade well control building, water main replacement.",1000,6995000,40,514407585
19351,Chenango,BAINBRIDGE (V),Bainbridge (V),"Lead Service Line Inventory, Upgrade Distribution System",1600,726000,40,515133585
18900,Chenango,VILLAGE OF GREENE,Greene (V),"Phase 1 - Water main replacement, Upgrade Distribution System",1800,20566400,35,535699985
19372,Chenango,NEW BERLIN (V),New Berlin (V),"Lead Service Line Inventory, Upgrade Distribution System",1000,398200,30,536098185
18328,Clinton,PLATTSBURGH CITY,Plattsburgh (C),"Phase 1 WTP, Source, Transmission, and Distribution Upgrades., Upgrade Water Treatment Plant, New Ground Water Source, Upgrade Transmission, Upgrade Distribution System",18000,0,1115,536098185
19489,Clinton,SCHUYLER FALLS (T),Clinton County,"Morrisonville WD Sands Road Extension to serve PFOA contaminated private wells., New Distribution System, New System Consolidation",4843,5500000,125,541598185
19093,Clinton,PLATTSBURGH CITY,Plattsburgh (C),"Phase 2 Water System Upgrades/ New GW Source Development, New Ground Water Source, Upgrade Transmission, Upgrade Distribution System",18000,5240000,105,546838185
19487,Clinton,PLATTSBURGH (C),Plattsburgh (C),"Phase 3 - drinking water system upgrades. , Upgrade Water Treatment Plant, New Ground Water Source, Upgrade Transmission",19840,8832000,65,555670185
18981,Clinton,MORRISONVILLE WD,Schuyler Falls (T),"Replacement of asbestos cement water main., Upgrade Distribution System",1300,5729375,65,561399560
18809,Clinton,ROUSES POINT WATER DISTRICT,Rouses Point (V),"WTP Replacement with membrane microfiltration with raw water pump station., New Water Treatment Plant, New Surface Water Source, New Pump Station",2139,10000000,55,571399560
18386,Clinton,REDFORD WATER DISTRICT,Saranac (T),"Upgrade Ground Water Source, Upgrade Storage, Upgrade Distribution System",486,1984430,50,573383990
18604,Clinton,BEEKMANTOWN WATER DISTRICT,Beekmantown (T),"New Public Water System., New Complete System (New System)",250,6862378,45,580246368
18867,Clinton,CHAMPLAIN (V),Champlain (V),"Replacement of failing watermain., Upgrade Distribution System",1000,1442000,45,581688368
19280,Clinton,PLATTSBURGH (C),Plattsburgh (C),"Lead service line inventory., Upgrade Distribution System",19840,324000,35,582012368
18974,Clinton,BLACK BROOK WD NO2,Black Brook (T),"Installation and replacement of water meters., Upgrade Other Expenses, Upgrade Other (OT)",77,845000,35,582857368
18027,Clinton,PLATTSBURGH AIRPORT,Clinton County,Upgrade Distribution System,47000,10402825,30,593260193
17683,Clinton,PLEASANT RIDGE WD,Plattsburgh (T),New Storage,168,1985000,30,595245193
19445,Clinton,ROUSES POINT VILLAGE WD,Rouses Point (V),"Lead service line inventory., Upgrade Distribution System",2195,273980,30,595519173
19251,Clinton,PERU WD,Peru (T),"Supplemental water source, new wells and transmission main., New Ground Water Source, New Transmission",2600,14394250,25,609913423
19252,Clinton,CHAZY WATER DISTRICT,Chazy (T),"WST rehab, water plant upgrades., Upgrade Water Treatment Plant, Upgrade Storage",690,2369000,15,612282423
18031,Columbia,VALATIE VILLAGE,Valatie (V),"New Surface Water Treatment Rule Compliance Facility, New Ground Water Source, Upgrade Transmission, Upgrade Distribution System",2000,1982750,145,614265173
19537,Columbia,VALATIE (V),Valatie (V),"New filtration and PFAS treatment facility., New Water Treatment Plant",2000,3942100,65,618207273
18821,Columbia,GREENPORT WD NO1,Greenport (T),"Source, Treatment and Distribution System Improvements., Upgrade Water Treatment Plant, Upgrade Ground Water Source, Upgrade Pump Station, Upgrade Distribution System",4050,6228500,60,624435773
19512,Columbia,KINDERHOOK (T),Kinderhook (T),"Watermain replacement and extension, New Distribution System, Upgrade Distribution System",600,2266000,55,626701773
19441,Columbia,HUDSON (C),Hudson (C),"Lead service line inventory., Upgrade Distribution System",6700,257500,40,626959273
18948,Columbia,CHATHAM VILLAGE,Chatham (V),"Replace water main on Austerlitz St & Houseman Ave., Upgrade Distribution System",2156,1432215,35,628391488
19300,Columbia,HUDSON (C),Hudson (C),"Upgrade water mains on Robinson and 3rd Street, Upgrade Distribution System",125,1026260,35,629417748
19391,Columbia,VALATIE VILLAGE,Kinderhook (T),"Develop new GW Source, Connection to existing distribution system, New Ground Water Source, Upgrade Distribution System",2000,2280000,15,631697748
19434,Columbia,KINDERHOOK (V),Kinderhook (V),"Lead service line inventory., Upgrade Distribution System",1100,192000,15,631889748
18620,Columbia,KINDERHOOK (V),Kinderhook (V),"Williams Street & Albany Avenue Water Main Replacement, AMI Meter System., Upgrade Distribution System",1170,1954500,15,633844248
18007,Cortland,MARATHON VILLAGE,Marathon (V),"New Storage, New Pump Station, Upgrade Distribution System",1107,2947345,50,636791593
18206,Cortland,CORTLAND (C),Cortland (C),"Clinton Avenue Distribution System Upgrade., Upgrade Distribution System",20095,2009463,50,638801056
18909,Cortland,CORTLAND (C),Cortland (C),"Homer Ave Reconstruction & Water Main Replacement Project., Upgrade Distribution System",21859,5455000,45,644256056
18888,Cortland,VILLAGE OF MARATHON,Marathon (V),"Water Main Crossings of the Tioughnioga River, Upgrade Distribution System",1107,775000,35,645031056
18452,Cortland,CORTLAND (C),Cortland (C),"Service Line Replacement, Upgrade Distribution System",20095,3150000,35,648181056
19520,Cortland,HOMER (V),Homer (V),"New Water Storage Tank West of I-81, New Storage",4514,4048000,30,652229056
19404,Cortland,HOMER WATER WORKS,Homer (V),"Lead Service Line Inventory., Upgrade Distribution System",4000,1050600,25,653279656
18348,Delaware,ROXBURY WATER DISTRICT,Roxbury (T),"Roxbury and Grand Gorge Joint project., New Surface Water Treatment Rule Compliance Facility, Upgrade Ground Water Source, Upgrade Distribution System",755,0,1150,653279656
18338,Delaware,SIDNEY VILLAGE,Sidney (V),"New Ground Water Supply and WTP to Replace Existing Inadequate Wells., Upgrade Ground Water Source, Extend Distribution System, Upgrade Distribution System",5100,0,1140,653279656
18803,Delaware,HOBART VILLAGE,Hobart (V),"Upgrade Water Treatment Plant, New Ground Water Source",370,0,1105,653279656
17417,Delaware,ARKVILLE WATER DISTRICT,Middletown (T),"Extend distribution, 100,000 gallons of storage, 100 gpm well, system consolidation., New Ground Water Source, New Storage, Extend Distribution System, Extend System Consolidation",400,1833375,90,655113031
18367,Delaware,FISHS EDDY COMMUNITY WATER SUP,Hancock (T),"Fish's Eddy Water District., New Ground Water Source, Upgrade Distribution System, New Water District",150,4184504,85,659297535
18133,Delaware,BOVINA CENTER WATER DIST. NO 1,Bovina (T),New Ground Water Source,142,657000,60,659954535
19046,Delaware,DELHI (V),Delhi (V),"Distribution, Storage, & Pump Station Upgrades, Upgrade Storage, Upgrade Pump Station, Upgrade Distribution System",3833,6500000,55,666454535
19379,Delaware,ANDES (T),Andes (T),"Installation of two wells, new treatment process, connection to distribution system, line existing reservoir, Upgrade Water Treatment Plant, Upgrade Surface Water Source, New Ground Water Source",350,2588550,50,669043085
19505,Delaware,MARGARETVILLE (V),Margaretville (V),"Hospital Tank replacement, meters, control system upgrades, Upgrade Storage, Upgrade Distribution System",514,1508801,45,670551886
18216,Delaware,WALTON VILLAGE,Walton (V),"Replace two tanks and aged mains on Bruce, Prospect and Burton Sts., Upgrade Storage, Upgrade Distribution System",3070,0,45,670551886
18916,Delaware,HAMDEN WATER DIST 1 - HAMDEN,Hamden (T),"Hamden WD Distribution System Upgrades., Upgrade Distribution System",110,334235,25,670886121
18831,Delaware,FRANKLIN VILLAGE,Franklin (V),"Replace existing 250,000-gal water storage tank., New Storage",481,767350,25,671653471
15301,Dutchess,TIVOLI (V),DCWWA,"Upgrade Water Treatment Plant, Upgrade Ground Water Source, New Storage, Upgrade Pump Station, Upgrade Distribution System, New System Consolidation",1035,0,1115,671653471
18090,Dutchess,REVERE PARK (E.FISH.WD#2),East Fishkill (T),"Interconnection of Hopewell West and Revere Park with Hopewell Hamlet via Fishkill Plains., New Distribution System, Upgrade Distribution System, New Inter-Connection",280,5093266,205,676746737
19170,Dutchess,PAWLING VILLAGE,Pawling (V),"New GW Sources, new WTP and related utility work on well fields., New Water Treatment Plant, New Ground Water Source",1907,4000000,95,680746737
19146,Dutchess,PINEWOOD KNOLLS WATER DISTRICT,East Fishkill (T),"Provide interconnections within the Town's existing water districts and develop new GW Sources to address PFOA/PFAS contamination, New Ground Water Source, Upgrade Distribution System",265,11183599,60,691930336
19326,Dutchess,AMENIA WATER DISTRICT NO 1,Amenia (T),"Lead Service Line Inventory., Upgrade Distribution System",1005,481000,60,692411336
19420,Dutchess,GREENFIELD WATER DISTRICT,DCWWA,"Interconnection of Greenfields Water System to Hyde Park Regional Water System to address PFAS contamination, Upgrade Water Treatment Plant, New Pump Station, New Inter-Connection",1050,13617622,55,706028958
16236,Dutchess,RED HOOK VILLAGE,Red Hook (V),"New Ground Water Source, Upgrade Ground Water Source, New Storage, Upgrade Distribution System",2214,0,55,706028958
18822,Dutchess,WAPPINGERS FALLS (V),Wappingers Falls (V),"New Greensand WTP for Mn Removal, New Water Treatment Plant, Upgrade Ground Water Source, Upgrade Storage",6500,3042840,55,709071798
18569,Dutchess,BRINKERHOFF WATER DISTRICT,Fishkill (T),"Interconnection to Merritt Park Water District, New Inter-Connection",3788,2633200,55,711704998
18918,Dutchess,RHINEBECK VILLAGE WATER,Rhinebeck (V),"Upgrade Water Treatment Plant, Upgrade Storage",4300,6649680,45,718354678
18536,Dutchess,PINEBROOK ESTATES,DCWWA,"Interconnection to DCWWA Hyde Park System., New Distribution System, New Inter-Connection",200,3489161,45,721843839
18830,Dutchess,WAPPINGERS FALLS VILLAGE,Wappingers Falls (V),"Interconnection between Wappingers Falls (V) and Wappinger (T)., New Inter-Connection",6000,1440252,45,723284091
18028,Dutchess,POUGHKEEPSIE CITY,City of Poughkeepsie,"Upgrade Other Expenses, Upgrade Other (OT)",28000,4311035,40,727595126
19187,Dutchess,AMENIA WD #1,Amenia (T),"Water District No. 1 Improvements, New Ground Water Source, New Storage, New Distribution System",1010,13338500,40,740933626
18698,Dutchess,POUGHKEEPSIE WATER TREATMENT FACILITY,Poughkeepsie JWB,"Remove and replace six UV units, Upgrade Water Treatment Plant",77000,560000,35,741493626
19402,Dutchess,CITY OF POUGHKEEPSIE,Poughkeepsie (C),"Lead Service Line Inventory., Upgrade Distribution System",32000,2453300,35,743946926
18140,Dutchess,RED HOOK VILLAGE,Red Hook (V),"New Storage, Upgrade Distribution System",2214,0,35,743946926
19575,Dutchess,WAPPINGERS FALLS (V),Wappingers Falls (V),"Wenliss Water Tank Rehabilitation, Upgrade Storage",6500,2274240,35,746221166
18723,Dutchess,POUGHKEEPSIE CITY,City of Poughkeepsie,Upgrade Distribution System,28000,15770000,35,761991166
18651,Dutchess,MILLERTON VILLAGE,Millerton (V),"Rehab. existing tank, repl. hydrants, rehab. water meters., Upgrade Storage, Upgrade Distribution System",1150,0,35,761991166
19032,Dutchess,PAWLING WD NO. 2,Pawling (T),"Pawling WD No. 2 Phase 1 Treatment, Storage, and Distribution Upgrades, Upgrade Water Treatment Plant, Upgrade Storage, Upgrade Distribution System",200,853500,35,762844666
19565,Dutchess,POUGHKEEPSIE (C),Poughkeepsie (C),"Water main replacement Phases 1 - 10, Upgrade Distribution System",32000,77804140,35,840648806
19576,Dutchess,WAPPINGERS FALLS (V),Wappingers Falls (V),"Water Meter Replacement, Upgrade Distribution System",6500,1725500,30,842374306
18566,Dutchess,BRINKERHOFF WATER DISTRICT,Fishkill (T),"Install GWUDI well filtration system, New Water Treatment Plant",3788,2317500,30,844691806
18949,Dutchess,MILLERTON VILLAGE,Millerton (V),"Replacement of watermain, minor updates to Well, Upgrade Distribution System",1150,6280454,25,850972260
18787,Dutchess,RED HOOK WATER DISTRICT #1,Red Hook (V),"Enhance interconnection with Red Hook (T); eliminate Well #4 due to PFAS, Upgrade Storage, Upgrade Distribution System, Upgrade Inter-Connection",1440,0,25,850972260
19173,Dutchess,POUGHKEEPSIE TOWNWIDE WD,Poughkeepsie (T),"Rehabilitation of two 5 MG tanks and improvements to Spackenkill Water Pump Station, Upgrade Storage, Upgrade Pump Station",40000,10563009,25,861535269
18864,Dutchess,UNITED WAPPINGER WATER IMPROVEMENT DIST.,Wappinger (T),"Installation of GAC for PFOA/PFOS removal., Upgrade Water Treatment Plant, Upgrade Distribution System",14000,5170000,25,866705269
18780,Dutchess,FISHKILL (V),Fishkill (V),"Water System Upgrades and rehabilitation of existing wells, Upgrade Water Treatment Plant, Upgrade Ground Water Source, Upgrade Storage",11289,10525000,20,877230269
19345,Dutchess,RED HOOK WD NO. 1,Red Hook (T),"Storage Tank Replacement on Kelly Road, Upgrade Storage",1600,4038900,20,881269169
19380,Dutchess,MILLERTON (V),Millerton (V),"Lead Service Line Inventory, Upgrade Distribution System",2000,128000,20,881397169
18568,Dutchess,BRINKERHOFF WATER DISTRICT,Fishkill (T),"Install bypass loop and new isolation valves, Upgrade Transmission",3788,1126600,20,882523769
19435,Dutchess,DUTCHESS COUNTY WWA,Dutchess County WA,"Lead Service Line Inventory, Upgrade Distribution System",15979,121326,15,882645095
19189,Dutchess,UNITED WAPPINGER WATER IMPROVEMENT DIST.,Wappinger (T),"Installation of 3 Wells, 1 MG Tank, New Ground Water Source, New Storage",14000,5922000,15,888567095
19564,Dutchess,BEACON (C),Beacon (C),"Cargill Reservoir Hypolimnetic Aeration System, Upgrade Surface Water Source",14370,2727167,15,891294262
19389,Dutchess,RED HOOK WATER DISTRICT NO. 1,Red Hook (T),"Lead Service Line Inventory, Upgrade Distribution System",1600,178000,15,891472262
19562,Dutchess,BEACON (C),Beacon (C),"Melzingah Reservoir Hypolimnetic Aeration System, Upgrade Surface Water Source",14370,1485384,15,892957646
19418,Dutchess,BRINKERHOFF WATER DISTRICT,Fishkill (T),"Installation of looping main, Upgrade Distribution System",3788,725000,10,893682646
19340,Dutchess,UNITED WAPPINGER WATER IMPROVEMENT DIST.,Wappinger (T),"Distribution main extension along Route 9., Extend Distribution System",14000,8326405,10,902009051
17700,Dutchess,DUTCHESS COUNTY WATER/WASTEWATER PLANT,DCWWA,"Rehabilitate/replace approximately 35,800 linear feet of water main associated with Crumwold Acres Subdivision, Upgrade Distribution System",7012,8806500,10,910815551
17693,Dutchess,DUTCHESS COUNTY WATER/WASTEWATER PLANT,DCWWA,"Replace Route 9 water main from Horseshoe Lane to Vanderbilt Lane,",7012,5014200,10,915829751
19547,Erie,AKRON VILLAGE,Akron (V),"Improve Water Storage Tank. Install TTHM Removal System, Upgrade Storage",2900,6500000,85,922329751
19553,Erie,WEST SENECA (T),West Seneca (T),"ECWA Connection/Conversion, Extend Distribution System, Upgrade Distribution System",1968,10327707,50,932657458
19118,Erie,ECWA DIRECT,Erie County Water Authority,"Replacement of the Van de Water Raw Water Pumping System, Upgrade Pump Station",228869,14280000,45,946937458
19131,Erie,ECWA DIRECT,Erie County Water Authority,"Rehabilitation of Filters 1 through 4 - Van de Water WTP, Upgrade Water Treatment Plant",228869,28706700,45,975644158
19053,Erie,CAYUGA CREEK WD,Alden (T),"Cayuga Creek Water District, New Water District",56,887600,45,976531758
19276,Erie,ALDEN (T),Alden (T),"Water District No. 5, New Water District",1500,20497000,45,997028758
19137,Erie,ECWA DIRECT,Erie County Water Authority,"Sturgeon Point WTP Washwater Tank Replacement., New Water Treatment Plant",228869,3744250,40,1000773008
18862,Erie,BUFFALO WATER AUTHORITY,Buffalo Water Board,"Water main and lead service line replacement., Upgrade Distribution System",276000,21450000,40,1022223008
19117,Erie,ECWA DIRECT,Erie County Water Authority,"Replacement of the Van de Water High Service Pump System, Upgrade Pump Station",228869,46440000,40,1068663008
19409,Erie,BUFFALO (C),Buffalo (C),"Lead Service Line Replacement., Upgrade Distribution System",900,5460000,40,1074123008
19442,Erie,GRAND ISLAND (T),Grand Island (T),"WTP Filtration and Pump Upgrades, Upgrade Water Treatment Plant, Upgrade Pump Station",21389,8717000,40,1082840008
19023,Erie,ECWA DIRECT,Erie County Water Authority,"Castle Hill Pump Station Replacement, Upgrade Pump Station",228869,2940400,40,1085780408
19116,Erie,ECWA DIRECT,Erie County Water Authority,"Transmission Main Improvements - Town Cheektowaga and City of Lackawanna, Upgrade Transmission",228869,9069860,35,1094850268
19431,Erie,ECWA DIRECT,ECWA,"Sandridge Water Storage Tank Rehabilitation, Upgrade Storage",228869,3485000,35,1098335268
19195,Erie,ECWA DIRECT,Erie County Water Authority,"Sturgeon Point WTP Filtered Water Bypass, Upgrade Water Treatment Plant",228869,2950400,35,1101285668
19219,Erie,ECWA DIRECT,Erie County Water Authority,"Van de Water WTP - Additional Filters No.5 and No.6, Upgrade Water Treatment Plant",228869,30246400,35,1131532068
19055,Erie,ECWA DIRECT,ECWA,"30-Inch Transmission Main Replacement on Various Areas, Upgrade Transmission",228869,4240300,35,1135772368
19288,Erie,ECWA DIRECT,Erie County Water Authority,"Lead Service Line Inventory., Upgrade Distribution System",550000,1221000,30,1136993368
18996,Erie,"TONAWANDA, TOWN WATER DEPT.",Tonawanda (T),"Water Treatment Plant Filtration Upgrades, Upgrade Water Treatment Plant",61729,5000000,30,1141993368
19115,Erie,ECWA DIRECT,Erie County Water Authority,"Interconnection to City of Buffalo to provide 20MGD, New Inter-Connection",228869,34127800,30,1176121168
19111,Erie,ECWA DIRECT,Erie County Water Authority,"Replacement of 18 Mile Creek Transmission Crossings, Upgrade Transmission",228869,16850000,30,1192971168
19282,Erie,TONAWANDA (T),Tonawanda (T),"Lead service line inventory., Upgrade Distribution System",88990,260245,25,1193231413
19114,Erie,ECWA DIRECT,Erie County Water Authority,"Line Maintenance Facility at Sturgeon Point WTP, Upgrade Other Expenses, Upgrade Other (OT)",228869,2997200,25,1196228613
19122,Erie,ECWA DIRECT,Erie County Water Authority,"Van De Water WTP and RWPS HVAC Upgrades, Upgrade Water Treatment Plant",228869,3831863,25,1200060476
19274,Erie,AKRON (V),Akron (V),"East Avenue Water Main Replacement, Upgrade Distribution System",3085,3028200,25,1203088676
18316,Erie,ANGOLA VILLAGE,Angola (V),"Upgrade Storage, Upgrade Distribution System",4200,5554415,25,1208643091
19112,Erie,ECWA DIRECT,Erie County Water Authority,"Water Main Replacement Town of Amherst, Upgrade Distribution System",228869,11490000,25,1220133091
19509,Erie,TONAWANDA (T),Tonawanda (T),"Electrical Upgrades at WTP and Pump Station, New Water Treatment Plant",72100,37080000,25,1257213091
19237,Erie,ECWA DIRECT,Erie County Water Authority,"Union Road Watermain Replacement, Upgrade Distribution System",228869,10439606,25,1267652697
18901,Erie,BOSTON (T),Boston (T),"Water Districts No.1 & 2 Water System Improvements, Upgrade Pump Station, Upgrade Distribution System",6604,16123067,20,1283775764
18605,Erie,GRAND ISLAND TOWN WATER DEPT.,Grand Island (T),"Baseline Road Water Main Improvements, Upgrade Distribution System",19500,5370000,15,1289145764
17690,Erie,CONSOLIDATED WATER DISTRICT,Lancaster (T),Upgrade Distribution System,500,2725000,10,1291870764
18323,Erie,ORCHARD PARK VILLAGE,Orchard Park (V),"Quaker St Water Line Replacement., Upgrade Distribution System",3100,1900000,10,1293770764
18595,Erie,EAST AURORA VILLAGE,East Aurora (V),"Oakwood Ave Water Main Replacement. , Upgrade Distribution System",7200,1463000,10,1295233764
19052,Erie,LANCASTER (T),Lancaster (T),"Cemetery Road Water Main Replacement, Upgrade Distribution System",3825,2200000,10,1297433764
17629,Essex,ESSEX WD,Essex (T),"WTP Upgrades and New GW Source., Upgrade Water Treatment Plant, New Ground Water Source",300,0,1165,1297433764
18275,Essex,KEESEVILLE V,Chesterfield (T),"WTP, storage, and distribution improvements., Upgrade Water Treatment Plant, Upgrade Storage, Upgrade Distribution System",2300,0,1155,1297433764
18184,Essex,CROWN POINT WD,Crown Point (T),"Rehab and upgrades to contaminated wells and replacing mains with severe break history., Upgrade Water Treatment Plant, New Ground Water Source, Upgrade Distribution System",995,0,1135,1297433764
18291,Essex,LAKE PLACID V,Lake Placid (V),"Upgrade Water Treatment Plant, New Storage, Upgrade Distribution System",5000,6209996,1070,1303643760
18270,Essex,CHILSON-EAGLE LAKE WD,Ticonderoga (T),"Chilson-Eagle Lake SWTR Compliance Project., New Surface Water Treatment Rule Compliance Facility, New Ground Water Source, Upgrade Distribution System",200,14000000,140,1317643760
18709,Essex,ELIZABETHTOWN WD,Elizabethtown (T),"New well to meet capacity standards, address use of springs (GWUDI), Telemetry & Treatment., Upgrade Water Treatment Plant, New Ground Water Source",800,3744565,115,1321388325
18982,Essex,WILLSBORO WD,Willsboro (T),"Phase I - new WTP, intake improvements, pump station upgrades., New Water Treatment Plant, New Storage, Upgrade Distribution System",1571,10310300,90,1331698625
18844,Essex,TICONDEROGA WD,Ticonderoga (T),"New Meters and Storage., New Storage, Upgrade Distribution System",5000,10104679,50,1341803304
18869,Essex,KEENE WD,Keene (T),"WD #2. New redundant well and upgrades to well building., New Ground Water Source",165,5025999,50,1346829303
19421,Essex,LAKE PLACID (V),Lake Placid (V),"Lead service line inventory., Upgrade Distribution System",2229,440632,30,1347269935
18423,Essex,RAY BROOK WD,North Elba (T),"Upgrade Storage, Upgrade Distribution System",400,0,30,1347269935
18887,Essex,MINERVA WD,Minerva (T),"Replacement of Approx. 6,400-ft of water main., Upgrade Distribution System",800,2400000,20,1349669935
18061,Franklin,TUPPER LAKE V,Tupper Lake (V),"New wells to replace SW source and inadequate DE plant., New Ground Water Source, Upgrade Distribution System",5500,0,1230,1349669935
19258,Franklin,TUPPER LAKE V,Tupper Lake (V),"Tupper Lake Intake and WTP Rehab. , Upgrade Water Treatment Plant, Upgrade Surface Water Source",5500,8867991,110,1358537926
19267,Franklin,MALONE V,Malone (V),"New production well, trans. main, upgrades well buildings, WTP and water meters. , Upgrade Water Treatment Plant, New Ground Water Source, Upgrade Transmission",13000,8681872,55,1367219798
19253,Franklin,CHATEAUGAY (V),Chateaugay (T),"Replacing spring house with new wells, water meters, and distribution work., New Ground Water Source, Upgrade Distribution System",1100,22911278,50,1390131076
19467,Franklin,MALONE (V),Malone (V),"Lead service line inventory., Upgrade Distribution System",8560,190358,40,1390321433
18531,Franklin,SARANAC LAKE V,Saranac Lake (V),"Distribution main replacement, Upgrade Distribution System",5800,10665000,30,1400986433
19427,Franklin,SARANAC LAKE (V),Saranac Lake (V),"Lead service line inventory., Upgrade Distribution System",5800,1151160,15,1402137593
18315,Fulton,GLOVERSVILLE (C) WATER WORKS,Gloversville (C),"New Storage, Upgrade Distribution System",17991,1000000,80,1403137593
18976,Fulton,GLOVERSVILLE (C) WATER WORKS,Gloversville (C),"WTP and Water Distribution system improvements. New booster pump station., Upgrade Water Treatment Plant, New Pump Station, Upgrade Distribution System",17991,5036753,70,1408174346
19488,Fulton,GLOVERSVILLE (C),Gloversville (C),"Water Meter Replacement project., Upgrade Other Expenses, Upgrade Other (OT)",15300,1350000,50,1409524346
18331,Fulton,MAYFIELD (V) WATER WORKS,Mayfield (V),"Replace Elevated Storage Tank., New Storage",817,90000,45,1409614346
19278,Fulton,GLOVERSVILLE (C) WATER WORKS,Gloversville Water Works,"New Transmission Main and upgrades to the distribution system., New Transmission, Upgrade Distribution System",17991,5309551,45,1414923897
17882,Fulton,BROADALBIN (V),Broadalbin (V),"Replace Aged Storage Tank, New Storage",1397,0,45,1414923897
19436,Fulton,GLOVERSVILLE WATER WORKS,Gloversville Water Works,"Lead service line replacement., Upgrade Distribution System",3838,7701485,40,1422625382
19092,Fulton,NORTHAMPTON (T) WATER DISTRICT,Northampton (T),"State Route 30 / Bridge Street Area Distribution Improvements, Upgrade Distribution System",1000,1188000,30,1423813382
18991,Genesee,WD NO. 6,Alexander (T),"New Water District No.6, New Distribution System",350,6270000,60,1430083382
19352,Genesee,STAFFORD (T),Stafford (T),"Town of Stafford Water District No. 12, New Water District",2409,3414000,60,1433497382
19057,Genesee,BATAVIA CITY,Batavia (C),"Water Treatment Plant and Source Improvements, Upgrade Water Treatment Plant, Upgrade Ground Water Source",16310,3679300,60,1437176682
18047,Genesee,RTE 98 WD,Batavia (T),"New Water District to serve areas East and West of Rte. 98, New Water District",318,5322464,50,1442499146
18045,Genesee,CREEK RD. WD,Batavia (T),New Water District,136,1407623,50,1443906769
18046,Genesee,PRATT RD. WD,Batavia (T),New Water District,55,1067974,50,1444974743
19136,Genesee,BETHANY (T),Bethany (T),"Water District No.5, New Water District",1000,12180000,50,1457154743
19224,Genesee,LEROY (T) WD 12,LeRoy (T),"WD #12 New Water Mains, New Water District",920,22200620,45,1479355363
19222,Genesee,GENESEE COUNTY WATER SUPPLY,Genesee County,"Phase 3 Water Supply Project, Part 2. Funding Phase 2 of #19559., New Distribution System",30000,46520000,35,1525875363
19223,Genesee,GENESEE COUNTY WATER SUPPLY,Genesee County,"Phase 3 Water Supply Project, Part 3. Funding Phase 3 of #19559., New Distribution System",30000,55680000,35,1581555363
19559,Genesee,GENESEE COUNTY,Genesee County,"Phase 3 Water Supply Project., New Distribution System",30000,155486524,35,1737041887
19221,Genesee,GENESEE COUNTY WATER SUPPLY,Genesee County,"Phase 3 Water Supply Project, Part 1. Funding Phase 1 of #19559. , New Distribution System",30000,50800000,35,1787841887
19497,Genesee,GENESEE COUNTY WATER SUPPLY,Genesee County,"Phase 2 - Chlorination Booster Upgrades, Tank THM Treatment, and Transmission Upgrades, Upgrade Water Treatment Plant, Upgrade Transmission, Upgrade Storage",57808,2812000,30,1790653887
18919,Genesee,MONROE COUNTY WATER AUTHORITY,Monroe County Water Authority,"1.5MG Tank Installation in Town of Pavilion., New Storage",8820,2317500,20,1792971387
15958,Greene,PRATTSVILLE WATER DISTRICT,Prattsville (T),"Address organics violations and inadequate source capacity, New Ground Water Source",410,0,1155,1792971387
18764,Greene,CATSKILL VILLAGE,Catskill (V),"WTP improvements to control DBPs and replace water mains on Main Street. , Upgrade Water Treatment Plant, Upgrade Distribution System",8000,0,1090,1792971387
18239,Greene,GREENVILLE WATER DISTRICT NO 1,Greenville (T),"Pressure, storage, and SCADA Improvements. Extend distribution system to serve contaminated private wells., New Storage, Extend Distribution System, Upgrade Distribution System",765,500000,1075,1793471387
19506,Greene,ATHENS (V),Athens (V),"Surface Water Treatment Plant Rehabilitation, Upgrade Surface Water Treatment Rule Compliance Facility",1586,1331338,95,1794802725
15704,Greene,COXSACKIE VILLAGE,Coxsackie (V),"New storage tank and transmission main upgrades. , Upgrade Transmission, New Storage",4010,0,75,1794802725
18917,Greene,ASHLAND WD,Ashland (T),"Ashland WD Extension Along NYS Rt. 23., Extend Distribution System",200,437750,70,1795240475
18614,Greene,CATSKILL VILLAGE,Catskill (V),"Storage, Distribution, and Booster Pump Improvements., New Storage, New Pump Station, Upgrade Distribution System",8000,5270000,45,1800510475
19579,Greene,SLEEPY HOLLOW LAKE WATER COMPANY,Sleepy Hollow Lake APO,"Sleepy Hollow Lake WTP Upgrades, Upgrade Water Treatment Plant",2460,8376498,40,1808886973
19106,Greene,TANNERSVILLE (V),Tannersville (V),"Emergency Water Storage Tank Replacement, Upgrade Storage",600,400000,30,1809286973
18430,Hamilton,BLUE MT LAKE WD,Indian Lake (T),"DBP Compliance Project., New Ground Water Source",400,5000000,80,1814286973
19260,Hamilton,LONG LAKE WD,Long Lake (T),"Rehab and replace existing Distribution System, well upgrades, WTP upgrades., Upgrade Ground Water Source, Upgrade Distribution System",800,46350000,35,1860636973
19094,Hamilton,SPECULATOR (V),Speculator (V),"Elm Lake Road Water Main Replacement and Transmission Upgrades, Upgrade Transmission, Upgrade Distribution System",408,2200000,35,1862836973
18562,Herkimer,ILION (V) WATER WORKS,Ilion (V),"Dedicated Well Transmission Main and High Priority Distribution Improvements., Upgrade Ground Water Source, New Transmission, Upgrade Storage, Upgrade Distribution System",8610,0,1135,1862836973
17422,Herkimer,"HERKIMER (T), WD NO. 3",Herkimer (T),"New Storage, New Pump Station, Distribution System Improvements., New Storage, New Pump Station, Upgrade Distribution System",320,0,1080,1862836973
18563,Herkimer,ILION (V) WATER WORKS,Ilion (V),"Medium Priority Distribution Imprvts and Eastern Mohawk Valley Regional Trans Main Connection. Related to Project #18897., Upgrade Distribution System, New System Consolidation",8610,28474350,145,1891311323
18860,Herkimer,HERKIMER VILLAGE,Herkimer (V),"High Priority System Upgrades and Eastern Mohawk Valley Regional Trans Main Connection. Related to Project #18897., Upgrade Storage, Upgrade Distribution System, New Inter-Connection",7606,17498670,125,1908809993
18711,Herkimer,EAST SCHUYLER WD,Schuyler (T),"New Distribution System and Eastern Mohawk Valley Regional Trans Main Connection. Related to Project #18897., New Transmission, New Distribution System, New System Consolidation",816,7391280,105,1916201273
18897,Herkimer,HERKIMER COUNTY INDUSTRIAL DEV AGENCY,Herkimer County IDA,"Eastern Mohawk Valley Regional Transmission Main. Related to projects Nos. 18715, 18716, 18860, 18563, 18711., New Transmission",22000,16620000,100,1932821273
18716,Herkimer,WEST HERKIMER WD EXT NO. 1,Herkimer (T),"WD Ext 1 and Eastern Mohawk Valley Regional Trans Main Connection. Related to Project #18897., New Transmission, New Distribution System, New System Consolidation",150,1839580,95,1934660853
18715,Herkimer,FRANKFORT (V) WATER WORKS,Frankfort (V),"Distribution System Improvements and Eastern Mohawk Valley Regional Trans Main Connection. Related to Project #18897., New Transmission, Upgrade Distribution System, New System Consolidation",2995,8667450,90,1943328303
18872,Herkimer,HERKIMER VILLAGE,Herkimer (V),"Phase 2 (2nd Priority) Water System Improvements., New Ground Water Source, New Storage, Upgrade Distribution System",7606,20597940,85,1963926243
18765,Herkimer,FRANKFORT (T),Frankfort (T),"Center and Zolad Roads WD., New Distribution System, New Water District",150,1365000,60,1965291243
17048,Herkimer,DOLGEVILLE (V) PWS,Dolgeville (V),"Manheim Elevated Storage Tank., New Storage",2166,5830000,55,1971121243
19425,Herkimer,ILION (V),Ilion (V),"Lead service line inventory., Upgrade Distribution System",7646,1077380,45,1972198623
19426,Herkimer,ILION (V),Ilion (V),"Lead service line replacement., Upgrade Distribution System",7646,4071590,45,1976270213
19423,Herkimer,HERKIMER (V),Herkimer (V),"Lead service line inventory., Upgrade Distribution System",7500,801340,45,1977071553
19424,Herkimer,HERKIMER (V),Herkimer (V),"Lead service line replacement., Upgrade Distribution System",7500,13208720,45,1990280273
18834,Herkimer,POLAND (V),Polland (V),"Well and Treatment Improvements., Upgrade Other Expenses, Upgrade Ground Water Source, Upgrade Transmission, Upgrade Pump Station, Upgrade Other (OT)",463,1400000,40,1991680273
19368,Herkimer,LITTLE FALLS (C),Little Falls (C),"Lead service line inventory., Upgrade Distribution System",4605,541780,40,1992222053
19261,Herkimer,LITTLE FALLS WATER SYSTEM,Little Falls (C),"Distribution system improvements, WTP improvements, Spruce Lake Dam rehab, Upgrade Other Expenses, Upgrade Water Treatment Plant, Upgrade Distribution System, Upgrade Other (OT)",4946,28428000,40,2020650053
18453,Herkimer,ILION (V) WATER WORKS,Ilion (V),"Replace Supplemental DE Filtration System, Upgrade Water Treatment Plant",8610,1113000,35,2021763053
19422,Herkimer,FRANKFORT (V),Frankfort (V),"Lead service line replacement., Upgrade Distribution System",2502,551050,35,2022314103
19446,Herkimer,DOLGEVILLE (V),Dolgeville (V),"Lead service line inventory., Upgrade Distribution System",2042,352260,35,2022666363
18528,Jefferson,PAMELIA WATER SYSTEM PROJECT,Pamelia (T),"Water system improvements and expansion., Upgrade Storage, Upgrade Distribution System, New Inter-Connection, Extend System Consolidation",2000,3750000,1165,2026416363
18418,Jefferson,PHILADELPHIA VILLAGE,Philadelphia (V),"Upgrade Surface Water Source, New Storage, New Pump Station",1800,0,1140,2026416363
18537,Jefferson,ORLEANS WATER IMPROVEMENTS,Orleans Water Improvements,"Consolidation of PWS w/ violations and to serve contaminated private wells. Related to DWSRF# 18096., Extend Distribution System",450,0,1135,2026416363
18173,Jefferson,BROWNVILLE (T),Brownville (T),"(T) Brownville WD#2., New Distribution System",424,0,1095,2026416363
16339,Jefferson,WELLESLEY ISLAND WATER CORP.,Wellesley Island Water Corp.,"New Water Treatment Plant, New Surface Water Source",548,2336000,140,2028752363
18911,Jefferson,LERAY TOWN WD 2,LeRay (T),"Consolidated Water District Extension along NYS Rt. 11 and former WD #3. Carey Well improvements, New Ground Water Source, Upgrade Distribution System, New Distribution System",2500,4000000,100,2032752363
19240,Jefferson,WEST CARTHAGE (V),West Carthage (V),"New storage tanks, distribution & transmission improvements, WTP improvements, Upgrade Water Treatment Plant, Upgrade Transmission, New Storage, Upgrade Distribution System",5016,21945180,100,2054697543
19154,Jefferson,WATERTOWN (C),Watertown (C),"WTP Upgrades to address DBPs, Upgrade Water Treatment Plant",50000,51500000,95,2106197543
19140,Jefferson,WATERTOWN TOWN WD 4,Watertown (T),"System Water Looping to address disinfection byproducts and consolidate Northland Estates and Pine Meadows PWS, Upgrade Distribution System",750,10135200,95,2116332743
18097,Jefferson,CLAYTON VILLAGE,Clayton (V),"Upgrade Water Treatment Plant, Upgrade Storage, Upgrade Pump Station, Upgrade Distribution System",2100,0,90,2116332743
18006,Jefferson,WATER DISTRICT NO. 6,Hounsfield (T),"Upgrade Transmission, Upgrade Distribution System, Extend Distribution System",450,7715000,85,2124047743
19119,Jefferson,PHILADELPHIA (T),Philadelphia (T),"New Proposed Water System, New Distribution System",183,6787746,80,2130835489
18425,Jefferson,WD#7,Hounsfield (T),"WD #7., New Distribution System",40,0,80,2130835489
18936,Jefferson,ALEXANDRIA VILLAGE,Alexandria Bay (V),"WTP upgrades and water main replacement., Upgrade Water Treatment Plant, Upgrade Distribution System",1900,13103000,70,2143938489
18853,Jefferson,HOUNSFIELD WSA #8,Hounsfield (T),"Water Service Area #8 to serve an area currently on individual wells., New Water District",1250,13162370,65,2157100859
19510,Jefferson,WD NO. 1,Lorraine (T),"Construction of WD No. 1., New Water District",160,4435000,65,2161535859
18876,Jefferson,TOWN OF LYME WATER DISTRICT NO. 6,Lyme (T),"New Distribution System - Three Mile Bay/Chaumont/Cape Vincent Areas., New Distribution System",150,6413810,65,2167949669
18180,Jefferson,CAPE VINCENT (T) WD#7,Cape Vincent (T),"New Water District #7, New Water District",495,8334000,65,2176283669
18126,Jefferson,BROWNVILLE (V),Brownville (V),"Replace Severely Aged Distribution Mains and Tank., New Storage, Upgrade Distribution System",2200,18948500,60,2195232169
18232,Jefferson,ADAMS VILLAGE,Adams (V),"Upgrade Ground Water Source, Upgrade Distribution System",2000,0,55,2195232169
17301,Jefferson,ADAMS VILLAGE,Adams (V),"Upgrade Water Treatment Plant, Upgrade Storage, Upgrade Distribution System",2000,0,55,2195232169
19527,Jefferson,BLACK RIVER (V),Black River (V),"Distribution, Maple St. Well, & New Source Improvements, New Ground Water Source, Upgrade Distribution System",4170,18200000,50,2213432169
17058,Jefferson,HOUNSFIELD WD 2,Hounsfield (T),Extend Distribution System,500,794439,50,2214226608
19528,Jefferson,PAMELIA CONSOLIDATED WD NO. 1,Pamelia (T),"Water Main Replacement and Chlorine Booster Station, Upgrade Other Expenses, Upgrade Distribution System, Upgrade Other (OT)",2350,8786000,45,2223012608
18175,Jefferson,SACKETS HARBOR VILLAGE,Sackets Harbor (V),"Replace existing intake piping and crib., Upgrade Surface Water Source, Upgrade Transmission",1300,0,45,2223012608
18927,Jefferson,VILLAGE OF ADAMS,Adams (V),"Water main and water meter replacement, Upgrade Distribution System",3300,6162490,45,2229175098
18052,Jefferson,CAPE VINCENT VILLAGE,Cape Vincent (V),Upgrade Water Treatment Plant,1500,3200000,45,2232375098
19126,Jefferson,DANC,Dev Authority of North Country,"Army Water Line Replacement - Phase 1, Upgrade Transmission",40237,0,45,2232375098
18884,Jefferson,TOWN OF HOUNSFIELD WATER SYSTEM,Hounsfield (T),"NYS Rt 3 Corridor Upgrades., New Transmission, Upgrade Transmission, Upgrade Storage, Upgrade Distribution System",1250,0,40,2232375098
19542,Jefferson,DEXTER (V),Dexter (V),"Route 180 Water Line Replacement, Upgrade Distribution System",1004,2380369,40,2234755467
19143,Jefferson,CLAYTON (V),Clayton (V),"Water Main Replacement and New Raw Water Intake Line and Screen, Upgrade Distribution System",2732,8481020,40,2243236487
18627,Jefferson,"WATERTOWN, CITY OF",Watertown (C),"Upgrades to soda ash system and replacement of filter backwash tank., Upgrade Water Treatment Plant",27861,1700000,40,2244936487
19453,Jefferson,CHAMPION WD#2,Champion (T),"Lead service line inventory., Upgrade Distribution System",712,26766,35,2244963254
18329,Jefferson,CHAUMONT VILLAGE,Chaumont (V),"Upgrade Transmission, Upgrade Distribution System",625,0,35,2244963254
19454,Jefferson,CLAYTON (V),Clayton (V),"Lead service line inventory., Upgrade Distribution System",2079,82391,35,2245045645
19466,Jefferson,LERAY (T),Leray (T),"Lead service line inventory., Upgrade Distribution System",10000,87962,30,2245133607
19461,Jefferson,ADAMS (V),Adams (V),"Lead service line inventory., Upgrade Distribution System",1775,519120,30,2245652727
19470,Jefferson,RUTLAND (T),Rutland (T),"Lead service line inventory., Upgrade Distribution System",1250,48419,30,2245701146
18236,Jefferson,LERAY TOWN WD 2,Leray (T),"Upgrade Ground Water Source, New Storage",2500,350000,30,2246051146
19471,Jefferson,SACKETS HARBOR (V),Sackets Harbor (V),"Lead service line inventory., Upgrade Distribution System",1550,54610,20,2246105757
19159,Jefferson,SACKETS HARBOR (V),Sackets Harbor (V),"E. Main St., E. Washington St., etc. Watermain Replacement, Upgrade Distribution System",871,2907000,15,2249012757
16549,Jefferson,NORTHLAND ESTATES,Northland Park Inc.,New Storage,540,82416,15,2249095173
18021,Jefferson,WATER DISTRICT #3,Ellisburg (T),"Serve private contaminated/poor yielding wells., Extend Distribution System",200,9000000,10,2258095173
18548,Lewis,HAMLET OF GLENFIELD WATER DISTRIBUTION S,Martinsburg (T),"Improvements to the existing water system including replacing the original water distribution system., Upgrade Distribution System",231,0,1080,2258095173
18745,Lewis,LOWVILLE VILLAGE,Lowville (V),"Groundwater Project Phase 1., Upgrade Water Treatment Plant, New Ground Water Source, New Pump Station",4000,3000000,1080,2261095173
19517,Lewis,VILLAGE OF TURIN,Turin (V),"Water Main Replacement and Water Storage Tank Replacement, Upgrade Storage, Upgrade Distribution System",300,6952500,100,2268047673
18658,Lewis,TOWN OF LOWVILLE WD 1,Lowville (T),"DBP related system improvements, Upgrade Water Treatment Plant",350,1500000,80,2269547673
19521,Lewis,PORT LEYDEN (V),Port Leyden (V),"Water System Improvements, Upgrade Water Treatment Plant, Upgrade Distribution System",704,10197000,60,2279744673
18579,Lewis,TOWN OF DIANA WATER DISTRICT,Diana (T),"Upgrade Wells 1 and 3, Distribution Looping and New Water Meters., Upgrade Ground Water Source, Upgrade Distribution System",618,6180000,60,2285924673
18825,Lewis,COPENHAGEN (V),Copenhagen (V),"Woodbattle Road WTP and wells Rehabilitation., Upgrade Water Treatment Plant",1000,1134000,60,2287058673
18756,Lewis,CONSTABLEVILLE (V),Constableville (V),"Replace watermain on N. Main street, Main street, W. Main street, Schuyler street, James street, John street, and High street., Upgrade Distribution System",310,4102000,45,2291160673
18735,Lewis,CASTORLAND (V),Castorland (V),"Denmark Storage Tank Replacement., New Storage",365,793000,45,2291953673
19464,Lewis,PORT LEYDEN (V),Port Leyden (V),"Lead service line inventory., Upgrade Distribution System",820,301778,40,2292255451
16683,Lewis,CONSTABLEVILLE VILLAGE,Constableville (V),Upgrade Transmission,310,1575000,35,2293830451
19458,Lewis,DIANA (T),Diana (T),"Lead service line inventory., Upgrade Distribution System",650,28818,30,2293859269
18746,Livingston,LIVINGSTON COUNTY WSA,Livingston County WSA,"Disinfection byproduct removal, new meters and SCADA, storage tank replacement, system consolidation., Upgrade Storage, Upgrade Distribution System, New System Consolidation",7975,1500000,1105,2295359269
19225,Livingston,LIVINGSTON COUNTY WSA,Livingston County WSA,"Leicester/York Water Supply; Expansion to Communities Impacted by AKZO Salt Mine, Extend Distribution System",3100,51345500,140,2346704769
19550,Livingston,AVON (V),Avon (V),"Upgrade Water Tanks and Water Mains, Upgrade Distribution System",6200,4828640,70,2351533409
19428,Livingston,GROVELAND (T),Groveland (T),"Water District No. 1, New Water District",350,6405000,55,2357938409
19249,Livingston,TOWN OF LIMA WD #5,Lima (T),"New Water District #5, New Water District",1500,24771500,50,2382709909
19546,Livingston,GENESEO (T),Geneseo (T),"Replace Approx. 23,000 LF of Water Main on Crossett Rd., NYS Rt 63, NYS Rt 39 & NYS Rt 20A, New Distribution System",108,3708000,45,2386417909
19549,Livingston,GENESEO (V),Geneseo (V),"Replace WM approx 3,300 LF on Oak and Second Streets, Upgrade Distribution System",240,2037550,35,2388455459
18708,Livingston,DANSVILLE (V),Dansville (V),"Replacement of aged undersized mains, Upgrade Distribution System",4463,6838170,35,2395293629
18655,Livingston,AVON VILLAGE PWS,Avon (V),"Replace existing aged undersized pump station, Upgrade Pump Station",2993,2048217,30,2397341846
19070,Livingston,YORK (T),York (T),"Flat Road Pump Station Upgrades, Upgrade Pump Station",1290,500000,30,2397841846
19121,Livingston,AVON TOWN WATER DISTRICT,Avon (T),"Townwide Water Main Replacement and Tank Improvements, Upgrade Storage, Upgrade Distribution System",3000,8577750,25,2406419596
18609,Livingston,LEICESTER (V),Leicester (V),"Pleasant Street Water Main Replacement., Upgrade Distribution System",45,882000,15,2407301596
18879,Madison,SKYRIDGE WD,SALT SPRINGS WD,"Town of Sullivan portion of Skyridge WD/Salt Springs WD project. Currently Inactive. Related to Project #18534., New System Consolidation, New Water District",304,2290909,95,2409592505
19501,Madison,WATER DISTRICT 14,Lenox (T),"Water District 14 Waterline Extension, New Water District",50,1100000,60,2410692505
18069,Madison,HAMILTON VILLAGE,Hamilton (V),"New Redundant Source., New Ground Water Source, Upgrade Distribution System",3904,3872800,55,2414565305
18859,Madison,WHITELAW WD,Sullivan (T),"Whitelaw WD - Extend water service to areas served by private wells., New Water District",180,5960000,50,2420525305
19343,Madison,ONEIDA (C),Oneida (C),"Improvements to Glenmore Dam, New Surface Water Source",21147,11850000,40,2432375305
19289,Madison,ONEIDA CITY,Oneida (C),"Lake St Pump Station Improvements., Upgrade Pump Station",12000,1916000,40,2434291305
18829,Madison,ONEIDA CITY,City of Oneia,"Construction of a new clear well, and rehab existing clear well., Upgrade Storage",12000,3048800,40,2437340105
18299,Madison,DERUYTER VILLAGE,DeRuyter (V),"NYS Route 13 Water Main Improvements., Upgrade Distribution System",643,478900,40,2437819005
19113,Madison,O-WE-RA POINT WATER SUPPLY,Owera Water Works Transport,"Installation of iron treatment system and other upgrades to aged infrastructure, New Water Treatment Plant, Upgrade Pump Station",100,484100,35,2438303105
19202,Madison,HAMILTON (V),Hamilton (V),"NY Rt. 12B Water Main Replacement, new hydrants, valves and services, Upgrade Distribution System",4107,6446770,30,2444749875
19310,Madison,MOUNT PLEASANT WD,Cazenovia (T),"Mount Pleasant WD Watermain Replacement, Upgrade Distribution System",60,750000,15,2445499875
18213,Monroe,ROCHESTER CITY,Rochester (C),"Cover Highland Reservoir, Upgrade Storage",214000,7200000,105,2452699875
19216,Monroe,ROCHESTER CITY,Rochester (C),"Hemlock Filtration Plant Filter Rehabilitation Project - Underdrain and Media Replacement, Upgrade Water Treatment Plant",214000,2260300,45,2454960175
18998,Monroe,ROCHESTER CITY,Rochester (C),"Lead Service Line Replacement, Upgrade Distribution System",214000,5100000,40,2460060175
18485,Monroe,ROCHESTER CITY,Rochester (C),"Scottrville Road Water Main Replacement, Upgrade Distribution System",214000,2200000,40,2462260175
19313,Monroe,ROCHESTER CITY,Rochester (C),"Cleaning & lining of approximately 22,000lf of main and 175 LSL replacements, Upgrade Distribution System",214000,2750000,40,2465010175
19277,Monroe,ROCHESTER (C),Rochester (C),"Lead Service Line Replacement 2024, Upgrade Distribution System",15000,48410000,40,2513420175
18421,Monroe,MCWA SHOREMONT WTP,Monroe County Water Authority,Upgrade Water Treatment Plant,310000,3000000,40,2516420175
19397,Monroe,MCWA SHOREMONT WTP,Monroe County Water Authority,"Lead Service Line Inventory, Upgrade Distribution System",558818,25390000,40,2541810175
18926,Monroe,MCWA SHOREMONT WTP,Monroe County Water Authority,"Installation of emergency scrubber for chlorine gas treatment, Upgrade Other Expenses, Upgrade Other (OT)",310000,300000,25,2542110175
19494,Monroe,MONROE COUNTY WATER AUTHORITY,Monroe County Water Authority,"Shoremont WTP - Replacement of GAC media to remove PFOA/PFOS, Upgrade Water Treatment Plant",400000,3050000,25,2545160175
18230,Monroe,MCWA SHOREMONT WTP,Monroe County Water Authority,Upgrade Distribution System,310000,855000,25,2546015175
19214,Monroe,MCWA SHOREMONT WTP,Monroe County Water Authority,"Glen Iris Dr. Watermain Replacement, Upgrade Distribution System",310000,498520,20,2546513695
18448,Montgomery,FONDA (V) WATER WORKS,Fonda (V),"Water system improvements, Upgrade Surface Water Treatment Rule Compliance Facility, Upgrade Transmission, Upgrade Storage",1080,0,1095,2546513695
19545,Montgomery,FLORIDA (T),Florida (T),"Fort Hunter Extension & Tank Improvements for DBPs, Upgrade Storage, Extend Distribution System",432,8111250,105,2554624945
19101,Montgomery,FORT PLAIN (V) WATER WORKS,Fort Plain (V),"PFOS removal at Lincoln Street Wells, Upgrade Water Treatment Plant",2400,1010000,85,2555634945
19556,Montgomery,ST JOHNSVILLE (V),St. Johnsville (V),"Disinfection Upgrades, Tank Rehab, Monroe St. Main Replacement, Upgrade Storage, Upgrade Distribution System",1643,2156669,55,2557791614
18412,Montgomery,CANAJOHARIE (V) WATER WORKS,Canajoharie (V),"Storage tank replacement; storage tank rehabilitation; distribution upgrades, New Storage, Upgrade Storage, Upgrade Distribution System",2300,0,50,2557791614
18894,Montgomery,PALATINE BRIDGE (V) WATER WORKS,Palatine Bridge (V),"Rt. 5 Watermain Replacement, Upgrade Distribution System",890,495500,35,2558287114
18810,Nassau,WA OF GREAT NECK NORTH,Water Auth - Great Neck North,"Phase 2 of Project #18146. Resiliency and redundancy at wells 2A, 5, 6, 8 and 11A, Backup generators at wells 6 and 10A, Upgrade Other Expenses, Upgrade Other (OT)",31400,0,1020,2558287114
18965,Nassau,TOWN OF HEMPSTEAD WD,Hempstead (T),"1,4-dioxane, PFOA/PFOS, and nitrate treatment for Well Nos. 1A & 2A at Levittown WD, Upgrade Water Treatment Plant",110000,6001000,130,2564288114
18670,Nassau,HEMPSTEAD (V),Hempstead (V),"1,4-dioxane treatment at Clinton Street Plant, Upgrade Water Treatment Plant",56000,18087119,90,2582375233
19328,Nassau,PORT WASHINGTON WD,Port Washington WD,"Installation of GAC to treat PFAS, Improvements to site buildings and electric service, Upgrade Water Treatment Plant",110000,12407000,85,2594782233
18964,Nassau,TOWN OF HEMPSTEAD WD,Hempstead (T),"Market Lane Plant Well Nos. 5A & 6B - AOP/GAC treatment for 1,4-dioxane and PFOA/PFOS removal, Upgrade Water Treatment Plant",110000,11860000,80,2606642233
18967,Nassau,TOWN OF HEMPSTEAD WD,Hempstead (T),"1,4-dioxane treatment for Well No. 13 at Levittown WD, Upgrade Water Treatment Plant",110000,8110000,80,2614752233
18969,Nassau,TOWN OF HEMPSTEAD WD,Hempstead (T),"1,4-dioxane, PFOA/PFOS, and nitrate treatment for Well Nos. 7, 11 & 12 at Roosevelt WD, Upgrade Water Treatment Plant",110000,22000000,80,2636752233
18963,Nassau,TOWN OF HEMPSTEAD WD,Hempstead (T),"East Meadow WD Wells No. 5 and 11 - AOP/GAC treatment for 1,4-dioxane, PFOA/PFOS, 1,1-DCA, and other VOCs removal, Upgrade Water Treatment Plant",110000,6100070,80,2642852303
18962,Nassau,TOWN OF HEMPSTEAD WD,Hempstead (T),"1,4-dioxane, PFOA/PFOS, and nitrate treatment for Wells No. 1 and 2 at Bowling Green Estates WD, Upgrade Water Treatment Plant",110000,9500000,80,2652352303
19064,Nassau,GARDEN CITY (V),Garden City (V),"Country Club Wells No. 13 and 14 - AOP/GAC treatment for 1,4-dioxane and PFOA/PFOS removal, Upgrade Water Treatment Plant",25000,8500000,80,2660852303
19065,Nassau,GARDEN CITY PARK WD,Garden City Park WD,"Wells No. 7 and 10 - GAC treatment for PFOA/PFOS removal, Upgrade Water Treatment Plant",15500,6500000,80,2667352303
19098,Nassau,WA OF WESTERN NASSAU,WAWNC,"Station 40 - AOP and GAC treatment to removal 1,4-dioxane, PFOA and PFOS, Upgrade Water Treatment Plant",120000,16521450,80,2683873753
18832,Nassau,ALBERTSON WD,Albertson Water District,"Well #4 GAC - PFOS/PFOA removal, Upgrade Water Treatment Plant",13500,9720000,80,2693593753
18849,Nassau,HICKSVILLE WD,Hicksville WD,"Plant 5 AOP treatment of 1,4-dioxane, PFOA and PFOS, Upgrade Other Expenses, New Water Treatment Plant, Upgrade Other (OT)",47810,9419000,80,2703012753
18966,Nassau,TOWN OF HEMPSTEAD WD,Hempstead (T),"1,4-dioxane treatment for Well Nos. 7A & 8A at Levittown WD, Upgrade Water Treatment Plant",110000,12000000,80,2715012753
19007,Nassau,PLAINVIEW WD,Plainview WD,"Plant No. 3 - AOP/GAC treatment for 1,4-dioxane and PFOA/PFOS removal, Upgrade Water Treatment Plant",35000,4074700,80,2719087453
19008,Nassau,PLAINVIEW WD,Plainview WD,"Plant No. 4 - AOP/GAC treatment for 1,4-dioxane removal, Upgrade Water Treatment Plant",35000,9273681,80,2728361134
19440,Nassau,BOWLING GREEN WD,Hempstead (T),"Installation of single-use ion exchange media to remove high levels of PFAS and perchlorate, Upgrade Water Treatment Plant",15000,14053320,80,2742414454
19003,Nassau,JERICHO WD,Jericho WD,"Well No. 22 - AOP/GAC treatment for 1,4-dioxane and PFOA/PFOS removal, Upgrade Water Treatment Plant",58000,13723000,80,2756137454
19099,Nassau,WESTBURY WD,Westbury Water District,"Well Nos. 10 & 14 - Nitrate removal system and AOP/GAC treatment, Upgrade Water Treatment Plant",20500,14960000,80,2771097454
19097,Nassau,WA OF WESTERN NASSAU,WAWNC,"Station 35 - AOP and GAC treatment to remove 1,4-dioxane, PFOA and PFOS, Upgrade Water Treatment Plant",120000,12500000,80,2783597454
18674,Nassau,TOWN OF HEMPSTEAD WD,Hempstead (T),"1,4-dioxane and VOC treatment at Well Nos. 5 and 6 at Uniondale WD, Upgrade Water Treatment Plant",110000,11500000,80,2795097454
19096,Nassau,WA OF WESTERN NASSAU,WAWNC,"Station 28 - GAC treatment to remove PFOA and PFOS, Upgrade Water Treatment Plant",120000,4160000,80,2799257454
19095,Nassau,WA OF WESTERN NASSAU,WAWNC,"Station 20 - AOP and GAC treatment to remove 1,4-dioxane, PFOA and PFOS, Upgrade Water Treatment Plant",120000,19250000,80,2818507454
19063,Nassau,GARDEN CITY (V),Garden City (V),"Hilton Park Plant Wells No. 15 and 16 - AOP/GAC treatment for 1,4-dioxane and PFOA/PFOS removal, Upgrade Water Treatment Plant",25000,9000000,80,2827507454
19062,Nassau,GARDEN CITY (V),Garden City (V),"Well No. 7 AOP to remove 1,4-dioxane, Upgrade Water Treatment Plant",25000,5200000,80,2832707454
16456,Nassau,EAST MEADOW WD,Hempstead (T),"New Ground Water Source, Upgrade Distribution System",46950,3100000,55,2835807454
19013,Nassau,GARDEN CITY (V),Garden City (V),"Well No. 9 - AOP/GAC treatment for 1,4-dioxane and PFOA/PFOS removal, Upgrade Water Treatment Plant",25000,7200000,50,2843007454
18671,Nassau,HEMPSTEAD (V),Hempstead (V),"1,4-dioxane treatment at Laurel Ave Plant (Well Nos. 7 and 9), Upgrade Water Treatment Plant",56000,6263074,50,2849270528
18997,Nassau,HICKSVILLE WD,Hicksville Water District,"Plant No. 6 - AOP/GAC treatment for 1,4-dioxane and PFOA/PFOS removal, Upgrade Water Treatment Plant",47810,12296000,45,2861566528
19004,Nassau,JERICHO WD,Jericho WD,"Well No. 33 - Perchlorate and Nitrate Removal, Upgrade Water Treatment Plant",58000,16325000,40,2877891528
19580,Nassau,JERICHO WD,Jericho WD,"Well 12 PFAS removal, Upgrade Water Treatment Plant",58000,8622130,40,2886513658
19010,Nassau,HICKSVILLE WD,Hicksville WD,"Plant No. 11 - AOP/GAC treatment for 1,4-dioxane, Upgrade Water Treatment Plant",47810,13996670,40,2900510328
19581,Nassau,JERICHO WD,Jericho WD,"Well 13 PFAS Removal, Upgrade Water Treatment Plant",58000,10200090,40,2910710418
19532,Nassau,FARMINGDALE (V) - PLANT 2,Farmingdale (V),"Plant No. 2 AOP/GAC treatment for 1,4-dioxane and PFOA/PFOS removal, Upgrade Water Treatment Plant",8550,13330672,40,2924041090
18968,Nassau,TOWN OF HEMPSTEAD WD,Hempstead (T),"1,4-dioxane treatment for Well Nos. 6 & 8 at East Meadow WD, Upgrade Water Treatment Plant",110000,12000000,40,2936041090
19417,Nassau,MINEOLA (V),Mineola (V),"Installation of GAC treatment system to address PFAS contamination at Well No. 6, Upgrade Water Treatment Plant",20600,8745730,40,2944786820
19393,Nassau,JERICHO WD,Jericho Water District,"Relocate existing GAC vessels to Well 29 and install new GAC vessels at Wells 18 and 19 to address PFAS contamination, Upgrade Water Treatment Plant",58000,17559440,40,2962346260
19392,Nassau,CARLE PLACE WD,Carle Place WD,"Installation of GAC system for treatment of PFAS at Wells 3 & 4, Upgrade Water Treatment Plant",9000,7649000,40,2969995260
19382,Nassau,WATER AUTHORITY OF GREAT NECK NORTH,WAGNN,"Installation of GAC and Anion Exchange treatment systems to remove PFAS, Upgrade Water Treatment Plant",32400,13693050,40,2983688310
19369,Nassau,WILLISTON PARK (V),Williston Park (V),"Well No.4 GAC PFAS treatment, New Water Treatment Plant",7300,8681870,40,2992370180
19371,Nassau,WILLISTON PARK (V),Williston Park (V),"Wells No. 1A and No. 2 GAC PFAS treatment, New Water Treatment Plant",7300,14224300,40,3006594480
19342,Nassau,MASSAPEQUA WATER DISTRICT,Massapequa Water District,New Water Treatment Plant,43000,1976250,40,3008570730
19337,Nassau,PORT WASHINGTON WD,Port Washington WD,"Installation of GAC treatment to remove PFAS at Hewlett Well No. 4, Upgrade Water Treatment Plant",30000,6873190,40,3015443920
19254,Nassau,HEMPSTEAD (T) ROOSEVELT WD,Hempstead (T),"Construction of radium removal treatment plant at Roosevelt Field WD Wells 7, 11, 12, Upgrade Water Treatment Plant",6100,22000000,40,3037443920
19009,Nassau,WESTBURY WD,Westbury WD,"Well No. 16 - AOP/GAC treatment for 1,4-dioxane and PFOA/PFOS removal, Upgrade Water Treatment Plant",20500,6877000,40,3044320920
19233,Nassau,SANDS POINT (V),Sands Point (V),"New GAC Treatment to Address PFAS at Wells 3 & 4., New Water Treatment Plant, Upgrade Ground Water Source",2900,10609000,40,3054929920
19231,Nassau,MANHASSET LAKEVILLE WD,Manhasset-Lakeville WD,"Removal of PFAS contamination at Spruce Ponds Plant., Upgrade Water Treatment Plant",45000,3600211,40,3058530130
18777,Nassau,ALBERTSON WD,Albertson Water District,"Well 3A - Installation of an AOP treatment system, Upgrade Water Treatment Plant",13500,10466000,40,3068996130
19207,Nassau,VILLAGE OF MINEOLA,Mineola (V),"Well 1 PFAS removal, Upgrade Water Treatment Plant",19117,9712000,40,3078708130
19015,Nassau,FRANKLIN SQUARE WD,Franklin Square WD,"Plant No. 1 - GAC treatment for PFOA/PFOS removal, Upgrade Water Treatment Plant",20000,5150000,40,3083858130
19190,Nassau,WESTBURY WD,Westbury WD,"State Street - GAC treatment for PFOA/PFOS removal and raising wellhead, Upgrade Water Treatment Plant, Upgrade Ground Water Source",20500,14371000,40,3098229130
19180,Nassau,WESTBURY WD,Westbury Water District,"Installation of new GAC system at the Wells 15 and 18 facility for PFAS removal, New Water Treatment Plant",20500,11054990,40,3109284120
19485,Nassau,PORT WASHINGTON WD,Port Washington WD,"New GAC to remove PFAS contamination at Well 7, Upgrade Water Treatment Plant",30000,8187470,40,3117471590
19583,Nassau,JERICHO WD,Jericho WD,"Well 28 PFAS Removal, Upgrade Water Treatment Plant",58000,5716500,40,3123188090
19582,Nassau,JERICHO WD,Jericho WD,"Well 23 PFAS Removal, Upgrade Water Treatment Plant",58000,8483080,40,3131671170
18684,Nassau,GARDEN CITY PARK WD,Garden City Park WD,"Plant No. 6 AOP treatment for 1,4-dioxane removal, Upgrade Water Treatment Plant",15500,3214000,40,3134885170
18683,Nassau,FARMINGDALE (V),Farmingdale (V),"Install treatment to remove 1,4-dioxane and PFOA/PFOS from Well Nos. 1-3., Upgrade Water Treatment Plant",8405,7652560,40,3142537730
19484,Nassau,PORT WASHINGTON WD,Port Washington WD,"New GAC to remove PFAS contamination at Well 6, Upgrade Water Treatment Plant",30000,8187470,40,3150725200
19338,Nassau,ALBERSTON WATER DISTRICT,Albertson WD,"Installation of GAC to treat PFAS at Shepherd Lane Well 1, Upgrade Water Treatment Plant",13500,9685000,40,3160410200
18633,Nassau,HEMPSTEAD (V),Hempstead (V),"Installation of new wells and Chemical Feed/Control Bldg., New Other Expenses, New Ground Water Source, New Other (OT)",56000,0,25,3160410200
19006,Nassau,CARLE PLACE WD,Carle Place WD,"Well 3 and 4 - Electrical Improvements, Upgrade Water Treatment Plant",9005,4098000,20,3164508200
19315,Nassau,HICKSVILLE WD,Hicksville WD,"Lead service line inventory., Upgrade Distribution System",48000,1086200,20,3165594400
18961,Nassau,GLEN COVE CITY,Glen Cove (C),"Nancy Court Pump Station Upgrades., Upgrade Pump Station",28000,2234000,20,3167828400
19235,Nassau,INC VILLAGE OF SANDS POINT WD,Sands Point (V),"Construction of new supply well, New Ground Water Source",2900,7337000,20,3175165400
19239,Nassau,OLD WESTBURY (V),Old Westbury (V),"Rehab Garvin Road water storage tank., Upgrade Storage",3200,5484000,20,3180649400
19229,Nassau,ALBERTSON WD,Albertson WD,"Improvements to Well 2 station, Upgrade Other Expenses, New Ground Water Source, Upgrade Other (OT)",13500,5347000,20,3185996400
19218,Nassau,BAYVILLE (V),Bayville (V),"Rehab of Plant No. 1-3, Upgrade Water Treatment Plant",8800,1661184,20,3187657584
19204,Nassau,PORT WASHINGTON WD,Port Washington WD,"Improvements to SCADA system,",34000,826000,20,3188483584
19018,Nassau,LONG BEACH CITY,Long Beach (C),"Well 16A Replacement, New Ground Water Source",35000,4993440,20,3193477024
19047,Nassau,LOCUST VALLEY WD,Locust Valley WD,"Raise elevation of Pump Station No. 4 for resiliency and redundancy during storm events, Upgrade Water Treatment Plant",7500,3150000,20,3196627024
16458,Nassau,LEVITTOWN WD,Hempstead (T),"New Ground Water Source, New Transmission",41800,4025000,15,3200652024
16453,Nassau,GARDEN CITY (V),Garden City (V),New Water Treatment Plant,25000,1601702,15,3202253726
15374,Nassau,ROCKVILLE CENTRE (V),Rockville Centre (V),"Rehab well 3a, Upgrade Ground Water Source",24700,290975,15,3202544701
18960,Nassau,GLEN COVE CITY,Glen Cove (C),"Construction of PTAS at Duck Pond Rd, Upgrade Water Treatment Plant",28000,16300000,15,3218844701
19325,Nassau,PORT WASHINGTON WD,Port Washington WD,"Lead service line inventory., Upgrade Distribution System",30000,1236000,15,3220080701
19376,Nassau,WILLISTON PARK (V),Williston Park (V),"Lead service line inventory., Upgrade Distribution System",7300,1137000,15,3221217701
19356,Nassau,FREEPORT (V),Freeport (V),"Lead service line inventory., Upgrade Distribution System",44199,500000,15,3221717701
15461,Nassau,PORT WASHINGTON WD,North Hempstead (T),New Transmission,34000,476000,15,3222193701
15663,Nassau,ROSLYN WD,North Hempstead (T),"Convert Well #3 DWTP to water lubrication, Upgrade Ground Water Source",17000,79725,15,3222273426
19377,Nassau,WILLISTON PARK (V),Williston Park (V),"Lead service line replacement., Upgrade Distribution System",7300,7307070,15,3229580496
19375,Nassau,MINEOLA (V),Mineola (V),"Lead service line inventory., Upgrade Distribution System",20600,1194000,15,3230774496
19374,Nassau,(T) HEMPSTEAD WD,Hempstead (T),"Lead service line inventory., Upgrade Distribution System",130000,741600,15,3231516096
19363,Nassau,GARDEN CITY (V),Garden City (V),"Lead service line inventory., Upgrade Distribution System",22384,3468100,15,3234984196
19359,Nassau,JERICHO WD,Jericho WD,"Lead service line replacement., Upgrade Distribution System",58000,9292000,15,3244276196
19358,Nassau,JERICHO WD,Jericho WD,"Lead service line inventory., Upgrade Distribution System",58000,1372000,15,3245648196
19355,Nassau,OLD WESTBURY (V),Old Westbury (V),"Lead service line inventory., Upgrade Distribution System",4600,1122000,15,3246770196
19353,Nassau,ROSLYN WD,Roslyn WD,"Lead service line inventory., Upgrade Distribution System",18619,3811510,15,3250581706
15261,Nassau,PLAINVIEW WD,Oyster Bay (T),Upgrade Water Treatment Plant,35000,2465614,15,3253047320
18481,Nassau,ROCKVILLE CENTRE (V),Rockville Centre (V),Upgrade Water Treatment Plant,24700,943800,15,3253991120
19324,Nassau,CARLE PLACE WD,Carle Place WD,"Lead service line inventory., Upgrade Distribution System",9000,1145000,15,3255136120
19323,Nassau,ALBERTSON WD,Albertson WD,"Lead service line inventory., Upgrade Distribution System",13500,1156000,15,3256292120
19322,Nassau,WESTBURY WD,Westbury WD,"Lead service line inventory., Upgrade Distribution System",20500,1186000,15,3257478120
19304,Nassau,BETHPAGE WD,Bethpage WD,"Plant No. 5 Construction of Permanent Building for existing AOP and GAC, New AOP, Upgrade Water Treatment Plant",28100,5169000,15,3262647120
15359,Nassau,ROCKVILLE CENTRE (V),Rockville Centre (V),"Rehab. wells 1a & 1b, Upgrade Ground Water Source",24700,153017,15,3262800137
19285,Nassau,LOCUST VALLEY WD,Locust Valley Water District,"Replacement of all existing outdated water meters., New Other Expenses, New Other (OT)",7500,1725000,15,3264525137
19220,Nassau,BETHPAGE WATER DISTRICT,Bethpage WD,"Installation of new North to South Transmission Main., New Transmission",28100,6925720,15,3271450857
15332,Nassau,SOUTH FARMINGDALE WD,South Farmingdale W.D.,"Elevated Tank Repairs & Repainting, Upgrade Storage",44700,616000,15,3272066857
15939,Nassau,FARMINGDALE (V),Farmingdale (V),Upgrade Water Treatment Plant,8405,75000,15,3272141857
15366,Nassau,ROCKVILLE CENTRE (V),Rockville Centre (V),"Replace treatment pump, Upgrade Water Treatment Plant",24700,45320,15,3272187177
19241,Nassau,OLD WESTBURY (V),Old Westbury (V),"Rehab Rolling Hill Lane water storage tank, Upgrade Storage",3200,2396000,15,3274583177
19238,Nassau,WILLISTON PARK (V),Williston Park (V),Replacement of aged electrical equipment,7516,5196000,15,3279779177
19236,Nassau,WILLISTON PARK (V),Williston Park (V),Replace aged chemical appurtenances,7516,1498000,15,3281277177
19230,Nassau,ALBERTSON WD,Albertson WD,"Miscellaneous Improvements to Well 5 station, Upgrade Pump Station",13500,5132000,15,3286409177
16417,Nassau,MASSAPEQUA WD,Oyster Bay (T),"Well No 1 Replacement of screen and well pump, Upgrade Ground Water Source",43000,290769,15,3286699946
19212,Nassau,JERICHO WD,Jericho Water District,"Water main replacement, Upgrade Transmission, Upgrade Distribution System",58000,19420000,15,3306119946
19208,Nassau,JERICHO WD,Jericho WD,"Replacement of 1.5MG Syosset water storage tank, New Storage",58000,14621000,15,3320740946
18796,Nassau,LONG BEACH CITY,Long Beach (C),"Replace Standpipe with new Storage Tank at Park Place WTP, New Storage",35000,9240540,15,3329981486
15452,Nassau,PORT WASHINGTON WD,Port Washington WD,Upgrade Storage,34000,5560426,15,3335541912
15380,Nassau,ROCKVILLE CENTRE (V),Rockville Centre (V),"Rehab Well 4C, Upgrade Ground Water Source",24700,257500,15,3335799412
15672,Nassau,MANHASSET LAKEVILLE WD,North Hempstead (T),"Install new water mains to eliminate dead ends, Upgrade Distribution System",43000,1075320,15,3336874732
17996,Nassau,WA OF WESTERN NASSAU CO,WA of Western Nassau County,"Iron removal at Wells 28A and 28B in Elmont, Upgrade Water Treatment Plant",10000,4429000,15,3341303732
15682,Nassau,MANHASSET LAKEVILLE WD,North Hempstead (T),"New transmission from wells to the Campbell treatment facility, New Transmission",43000,836360,15,3342140092
19038,Nassau,PORT WASHINGTON WD,Port Washington WD,"Neulist Avenue Well Station Upgrades, Upgrade Water Treatment Plant",34000,10278000,15,3352418092
15673,Nassau,ROSLYN WD,North Hempstead (T),Upgrade Water Treatment Plant,17000,234068,15,3352652160
15384,Nassau,ROCKVILLE CENTRE (V),Rockville Centre (V),"Rehab Tank #3, Upgrade Storage",24700,911550,15,3353563710
15460,Nassau,PORT WASHINGTON WD,North Hempstead (T),"Construct New Well #4, Upgrade Ground Water Source",34000,1428000,15,3354991710
19482,Nassau,LONG BEACH (C),Long Beach (C),"Replacement of water mains within the ""Walks"" area of the City of Long Beach, Upgrade Distribution System",35000,1075000,10,3356066710
19413,Nassau,ROCKVILLE CENTRE (V),Rockville Centre (V),"Replacement of undersized distribution main along several roads, Upgrade Distribution System",24700,1285275,10,3357351985
19234,Nassau,SANDS POINT (V),Sands Point (V),Replacement emergency power generator,2800,2656000,10,3360007985
19228,Nassau,ROSLYN WD,Roslyn Water District,Installation of natural gas generator at Plant No. 3 + 4,17000,655750,10,3360663735
19200,Nassau,CARLE PLACE WD,Carle Place WD,Upgrade Distribution System,9005,14022000,10,3374685735
19183,Nassau,WESTBURY WD,Westbury Water District,"Replacement of aging water mains, Upgrade Distribution System",20500,12339000,10,3387024735
18643,Nassau,WA OF GREAT NECK NORTH,WAGNN,"Watermain replacement project, Upgrade Distribution System",31400,8763714,10,3395788449
19050,Nassau,WEST HEMPSTEAD WD,West Hempstead WD,"Birch Street WTP Electrical Resiliency Improvements, Upgrade Water Treatment Plant",32031,5706200,10,3401494649
19048,Nassau,ROCKVILLE CENTRE (V),Rockville Centre (V),"Water Main Replacement, Upgrade Distribution System",24700,4270425,10,3405765074
18587,Niagara,NIAGARA FALLS WATER BOARD,Niagara Falls Water Board,"Beech Ave Storage Tank Replacement, Upgrade Storage",48500,15240000,60,3421005074
18743,Niagara,NORTH TONAWANDA CITY,North Tonawanda (C),"WTP Improvements, Upgrade Water Treatment Plant",33262,0,60,3421005074
19176,Niagara,NORTH TONAWANDA CITY,North Tonawanda (C),"Phase 2 - Filter Improvements, Upgrade Water Treatment Plant",33262,16315200,55,3437320274
19056,Niagara,NIAGARA FALLS WATER BOARD,Niagara Falls Water Board,"Water Main Replacement and WTP Upgrades, Upgrade Water Treatment Plant, Upgrade Distribution System",55593,10025000,55,3447345274
18294,Niagara,LOCKPORT CITY WTP,Lockport (C),Upgrade Transmission,22279,0,50,3447345274
19290,Niagara,LOCKPORT (C),Lockport (C),"Lead Service Line Inventory, Upgrade Distribution System",20722,124630,45,3447469904
19405,Niagara,NIAGARA FALLS WATER BOARD,Niagara Falls WB,"Lead Service Line Inventory, Upgrade Distribution System",48500,472780,40,3447942684
18420,Niagara,NORTH TONAWANDA CITY,North Tonawanda (C),"New Other Expenses, New Other (OT)",33262,698000,40,3448640684
18253,Niagara,NIAGARA WATER IMPROVEMENT AREA,Niagara (T),"Rehab 1-MG Lockport Road Storage Tank in (T) Niagara, Upgrade Storage",8978,1193696,40,3449834380
19027,Niagara,LOCKPORT (C),Lockport (C),"Raw Water Pump Station Emergency Generator, Upgrade Pump Station",21165,800000,40,3450634380
18588,Niagara,NIAGARA FALLS WATER BOARD,NiagaraFalls Public Water Auth,"Watermain and Lead Service Replacement, Upgrade Distribution System",55593,0,35,3450634380
19281,Niagara,NORTH TONAWANDA (C),North Tonawanda (C),"Lead service line inventory, Upgrade Distribution System",30400,291600,35,3450925980
18841,Niagara,NIAGARA FALLS WATER BOARD,Niagara Falls Water Board,"Replacement of aged and undersized distribution main, and appurtenances, Upgrade Distribution System",55593,5300000,35,3456225980
19054,Niagara,NIAGARA COUNTY WATER DISTRICT,Niagara County Water District,"WTP Wash Water Tank Improvements, Upgrade Water Treatment Plant",150000,2076250,35,3458302230
19042,Niagara,LEWISTON (V),Lewiston (V),"Distribution and Transmission Resiliency Upgrades, Upgrade Transmission, Upgrade Distribution System",2594,1200000,35,3459502230
19419,Niagara,"NEWFANE WD NO1,2,3 CONSOL",Newfane (T),"Replacement of WM on Jackson Street, Upgrade Distribution System",3485,1150000,30,3460652230
19226,Niagara,PORTER (T),Porter (T),"Replacement of Approx 15,000LF of WM w/in 5 Areas of Porter (T), Upgrade Distribution System",410,6785000,30,3467437230
18921,Niagara,NEWFANE WD#4,Newfane (T),"Approximately 2,400 ft main replacement, Upgrade Distribution System",6196,1102615,25,3468539845
19109,Niagara,ROYALTON TOWNWIDE WD,Royalton (T),"Watermain Replacement in Hamlet of Gasport, Upgrade Distribution System",1296,5900000,25,3474439845
18415,Niagara,PORTER MASTER IMPROVEMENT AREA,Porter (T),Upgrade Storage,6920,5805000,25,3480244845
18571,Niagara,LOCKPORT WD#3,Lockport (T),"Water District No. 3, Phase 2 Distribution System Improvements, Upgrade Distribution System",19653,4095000,20,3484339845
18541,Niagara,CAMBRIA WATER DISTRICT,Cambria (T),"Saunders Settlement Rd Water Main Replacement, Upgrade Distribution System",5393,1450000,15,3485789845
19511,Niagara,PENDLETON (T),Pendleton (T),"Campbell Blvd Watermain Replacement, New Distribution System",31,1886000,10,3487675845
17604,NY City,NEW YORK CITY-CATSKILL,DELAWARE SYSTEM,"Hillview Reservoir Chambers Reconstruction-(Phase 4 of 17171), General Chamber Improvements, Flow Control & New Chemical Facilities, SCADA, Upgrade Surface Water Treatment Rule Compliance Facility",6552718,5607922,2125,3493283767
19362,NY City,NEW YORK CITY - CROTON SYSTEM,NYCMWFA,"Croton Filtration Plant (Phase 17 of 16479), New Surface Water Treatment Rule Compliance Facility",1000000,278000000,130,3771283767
18823,NY City,NEW YORK CITY - CROTON SYSTEM,NYCMWFA,"Croton Filtration Plant (Phase 16 of 16479), New Surface Water Treatment Rule Compliance Facility",1000000,0,90,3771283767
19502,NY City,NEW YORK CITY,NYCMWFA,"3rd city tunnel, stage2 Bkln/Qns, shaft 17B-1 & 18B-1 [Phase 3 of DWSRF 18828)], New Transmission",8271000,141000000,85,3912283767
18886,NY City,NEW YORK CITY-CATSKILL,DELAWARE SYSTEM,"3rd city tunnel, stage2 Bkln/Qns, shaft 17B-1 & 18B-1 [Phase 2 of DWSRF 18828)], New Transmission",6552718,150000000,85,4062283767
18828,NY City,NEW YORK CITY-CATSKILL,DELAWARE SYSTEM,"3rd city tunnel, stage2 Bkln/Qns, shaft 17B-1 & 18B-1 (C547A), critical redundancy, Instr. and Tele, New Transmission",6552718,0,85,4062283767
19504,NY City,NEW YORK CITY,NYCMWFA,"Kensico-Eastview Connection - Phase 2, Upgrade Transmission",8271000,1609033000,55,5671316767
19107,NY City,NEW YORK CITY-CATSKILL,DELAWARE SYSTEM,"Kensico-Eastview Connection - Phase 1, Upgrade Transmission",6552718,50000000,55,5721316767
19321,NY City,NEW YORK CITY,NYCMWFA,"Lead service line replacement (Area F), Upgrade Distribution System",15168,8365970,40,5729682737
19320,NY City,NEW YORK CITY,NYCMWFA,"Lead service line replacement (Area E), Upgrade Distribution System",37749,14411320,40,5744094057
19319,NY City,NEW YORK CITY,NYCMWFA,"Lead service line replacement (Area D)., Upgrade Distribution System",15929,9780120,40,5753874177
19318,NY City,NEW YORK CITY,NYCMWFA,"Lead service line replacement (Area C)., Upgrade Distribution System",24872,5686580,40,5759560757
19317,NY City,NEW YORK CITY,NYCMWFA,"Lead service line replacement (Area B)., Upgrade Distribution System",72903,12022780,40,5771583537
19316,NY City,NEW YORK CITY,NYCMWFA,"Lead service line replacement (Area A)., Upgrade Distribution System",49440,7218660,40,5778802197
18699,NY City,NEW YORK CITY-CATSKILL/DELAWARE SYSTEM,NYCMMFA,Delaware aqueduct shaft 18 electrical upgrades,6552718,10823816,30,5789626013
18596,Oneida,RT. 365/SCONONDOA/SNYDER RD WD (SWP),Verona (T),"Extension of water distribution system, new pump station and storage tank, rehab existing storage tank",1795,0,1160,5789626013
18289,Oneida,ROME CITY,Rome (C),"NW Rome Re-Phase 3 Water Project., New Storage, New Pump Station, New Distribution System",32000,11235000,120,5800861013
16889,Oneida,NYS ROUTE 5/233 CORRIDOR WATER PROJECT,Westmoreland (T),"New system to serve area with private contaminated wells, consolidate public water supply.",300,7265000,95,5808126013
18805,Oneida,VERNON (T) CENTER WD,Vernon (T),"Vernon Center WD Serve area with private contaminated wells, New Water District",530,9346007,85,5817472020
18131,Oneida,SAUQUOIT CONSOLIDATED WD (T/O/PARIS),Paris (T),"Saquoit WD Upgrades., New Water Treatment Plant, New Ground Water Source, Upgrade Transmission",2639,5250000,70,5822722020
18883,Oneida,ORISKANY FALLS VILLAGE,Oriskany Falls (V),"Booster pump station and water main upgrades, New Pump Station, Upgrade Distribution System",682,1300000,60,5824022020
18929,Oneida,MOHAWK VALLEY WATER AUTHORITY,MVWA,"Hanger Zone Tank Reconfiguration and main replacement, New Storage, Upgrade Storage",130000,14700000,45,5838722020
18922,Oneida,MOHAWK VALLEY WATER AUTHORITY,MVWA,"Phase 3 RW Transmission Main Upgrades, New Transmission",120000,55600000,45,5894322020
18335,Oneida,MOHAWK VALLEY WATER AUTHORITY,MVWA,"Toby Road Tank 3., New Storage",130000,13323000,40,5907645020
19437,Oneida,BOONVILLE (V),Boonville (V),"Lead service line inventory., Upgrade Distribution System",2500,762000,40,5908407020
17651,Oneida,MOHAWK VALLEY WATER AUTHORITY,Upper M V Regional WB,Upgrade Distribution System,120000,9270000,40,5917677020
19536,Oneida,ROME (C),Rome (C),"Kessinger Dam Rehabilitation, Upgrade Surface Water Source",37300,7200000,35,5924877020
18938,Oneida,WATERVILLE (V),Waterville (V),"Stafford Ave Area WM Replacement., Upgrade Distribution System",1526,4400000,35,5929277020
19535,Oneida,ROME (C),Rome (C),"Boyd Dam Rehabilitation, Upgrade Surface Water Source",37300,3100000,35,5932377020
18947,Oneida,WATERVILLE VILLAGE,Waterville (V),"Relocation of booster pump station, Upgrade Pump Station",1750,400000,35,5932777020
19472,Oneida,ROME (C),Rome (C),"Lead service line inventory., Upgrade Distribution System",30000,412000,35,5933189020
18416,Oneida,CLINTON VILLAGE,Clinton (V),"Upgrade Storage, Upgrade Distribution System",3000,2510000,30,5935699020
19182,Oneida,TRENTON (T),Trenton (T),"Hamlet of Barneveld distribution and storage improvements, Upgrade Storage, Upgrade Distribution System",300,7205880,30,5942904900
19286,Oneida,SHERRILL - KENWOOD WD,Sherrill (C),"Lead service line inventory., Upgrade Distribution System",3500,25750,20,5942930650
18721,Onondaga,JORDAN VILLAGE,Jordan (V),Village's share of Elbridge (V) / Elbridge (T) / Jordan (V) Joint Water System Upgrades.,1400,3500000,1185,5946430650
18720,Onondaga,ELBRIDGE (V),Elbridge (V),Village's share of Elbridge (V) / Elbridge (T) / Jordan (V) Joint Water System Upgrades.,1100,3500000,1180,5949930650
18719,Onondaga,ELBRIDGE (T),Elbridge (T),Town's share of Elbridge (V) / Elbridge (T) / Jordan (V) Joint Water System Upgrades.,1000,5000000,1180,5954930650
18915,Onondaga,TOWN OF LAFAYETTE,LaFayette (T),"New water system to serve Town of LaFayette., New Ground Water Source, New Storage, New Pump Station",1400,26460000,95,5981390650
19100,Onondaga,SKANEATELES WDS,Skaneateles (T),"New Water District, Watermain Extension, and Water Storage Tank near Andrews Road, New Storage",3500,7877500,80,5989268150
19541,Onondaga,ROUTE 11A WATER DISTRICT,Tully (T),"Route 11A WD Improvement Project, Upgrade Water District",164,3694000,60,5992962150
18534,Onondaga,SKYRIDGE,SALT SPRINGS JOINT PROJECT,"Skyridge WD/Salt Springs WD Joint Water Project., New System Consolidation, New Water District",100,11227000,55,6004189150
19165,Onondaga,SYRACUSE CITY,Syracuse (C),"Guilford, Brookford and Westminster Booster Pump Station Replacement, New Pump Station",192000,3707200,55,6007896350
19162,Onondaga,SYRACUSE CITY,Syracuse (C),"Bowe's Gatehouse Replacement, Upgrade Transmission",192000,6077000,50,6013973350
18706,Onondaga,SYRACUSE CITY,Syracuse (C),"Intake No. 2 Extension., Upgrade Surface Water Source",192000,14011500,50,6027984850
18305,Onondaga,OCWA,Onondaga County Water Auth.,"Lake Ontario Water Treatment Plant Improvements Phase 3 - Clearwells., Upgrade Water Treatment Plant",256000,33250000,50,6061234850
19031,Onondaga,SYRACUSE CITY,Syracuse (C),"Lafayette Super High Service District Improvements, Upgrade Pump Station",192000,3432401,50,6064667251
18543,Onondaga,SYRACUSE CITY,Syracuse (C),"Replace chlorine gas systems with NaOCl., Upgrade Water Treatment Plant",192000,3543200,45,6068210451
18559,Onondaga,SYRACUSE CITY,Syracuse (C),"One of the three transmission conduits to the City of Syracuse, sections replaced., Upgrade Transmission",192000,1671175,45,6069881626
18913,Onondaga,ONONDAGA COUNTY WATER AUTHORITY,Onondaga County WA,"Replacement of Solvay Potable Water Pump Station, New Pump Station",340000,2000000,45,6071881626
19331,Onondaga,SYRACUSE (C),Syracuse (C),"Mosley Pump Station Replacement and Distribution Upgrades, Upgrade Pump Station",146000,3700000,45,6075581626
19284,Onondaga,BUSSEY AND NORTON ROADS WD EXTENSION,Onondaga (T),"Bussey and Norton Roads Consolidated Water Supply District Extension, New Water District",156,2378205,45,6077959831
19248,Onondaga,SYRACUSE CITY,Syracuse (C),"Replacement of Skaneateles Creek Weir Flume, Upgrade Other Expenses, Upgrade Other (OT)",192000,310000,45,6078269831
19172,Onondaga,SYRACUSE CITY,Syracuse (C),"Shove Park Blow-Off Replacement and Stream Crossing Upgrades, Upgrade Transmission",192000,500000,45,6078769831
19166,Onondaga,SYRACUSE CITY,Syracuse (C),"PRV Replacement Project, Upgrade Other Expenses, Upgrade Other (OT)",192000,746750,45,6079516581
19408,Onondaga,SYRACUSE (C),Syracuse (C),"Lead Service Line Replacement., Upgrade Distribution System",8600,41341728,40,6120858309
19407,Onondaga,SYRACUSE (C),Syracuse (C),"Lead Service Line Inventory., Upgrade Distribution System",160000,2266000,40,6123124309
19163,Onondaga,SYRACUSE CITY,Syracuse (C),"Camillus Ravine Rehabilitation Project - Transmission Main, Upgrade Transmission",192000,1030000,40,6124154309
18912,Onondaga,OCWA,Onondaga County Water Auth,"Salt Springs Water Storage - New Tank and Rehab Existing Tank., Upgrade Storage, New Storage",256000,3523000,35,6127677309
18848,Onondaga,TOWN OF DEWITT CONSOLIDATED WD NO. 1,DeWitt (T),"2020 Water System Improvements., Upgrade Storage, Upgrade Pump Station, Upgrade Distribution System",25000,5900000,35,6133577309
19400,Onondaga,JORDAN (V),Jordan (V),"Lead Service Line Inventory., Upgrade Distribution System",3600,313200,30,6133890509
18914,Onondaga,OCWA,Onondaga County Water Auth,"Replacement of Warners Water Storage Tank, New Storage",256000,1081500,30,6134972009
18440,Onondaga,OCWA,OCWA,"Oakridge Storage Tank Replacement., Upgrade Storage",256000,2400000,30,6137372009
18438,Onondaga,OCWA,Onondaga County Water Authorit,"Upgrade Cl2 System at Eastern and Western Reservoirs., Upgrade Storage",256000,1100000,30,6138472009
19174,Onondaga,SYRACUSE CITY,Syracuse (C),Water Department Security Fence Improvements,192000,1184500,30,6139656509
18990,Onondaga,OCWA,Onondaga County Water Authority,"Tug Hill Booster Pump Station, New Pump Station",256000,2000000,25,6141656509
19401,Onondaga,ELBRIDGE (T),Elbridge (T),"Lead Service Line Inventory., Upgrade Distribution System",3600,442656,25,6142099165
19403,Onondaga,ELBRIDGE (V),Elbridge (V),"Lead Service Line Inventory., Upgrade Distribution System",3600,288144,25,6142387309
18989,Onondaga,OCWA,Onondaga County Water Authority,"Lake Ontario WTP Distribution Garage, Upgrade Other Expenses, Upgrade Other (OT)",256000,3000000,15,6145387309
19125,Ontario,RUSHVILLE (V),Rushville (V),"WTP Improvements to address harmful algal blooms and cyanotoxins, Upgrade Water Treatment Plant",2028,1500000,80,6146887309
18456,Ontario,RT. 14 WD JOINT PROJECT,Phelps (T),"Towns of Phelps, Geneva, and Waterloo Joint Project., New Inter-Connection, New Water District",262,2929753,75,6149817062
19203,Ontario,MARBLETOWN-WHITE RD. WD,Phelps (T),"White Road WD Extension and Watermain Replacement, Upgrade Distribution System, Extend Water District",80,604776,65,6150421838
19158,Ontario,TOWN OF BRISTOL WD NO. 1,Bristol (T),"Day Road Tank Improvements to Address DBPs, Upgrade Storage",2136,203786,55,6150625623
19036,Ontario,GORHAM TOWN WD,Gorham (T),"Comprehensive WTP Improvements, Upgrade Water Treatment Plant, Upgrade Pump Station",4500,0,50,6150625623
19292,Ontario,CANANDAIGUA (C),Canandaigua (C),"Lead Service Line Inventory., Upgrade Distribution System",11000,869300,35,6151494923
19516,Ontario,CITY OF CANANDAIGUA,Canandaigua (C),"Rehabilitation of settling basin equipment, New Other Expenses, New Other (OT)",39239,1266000,35,6152760923
18542,Ontario,CANANDAIGUA TOWN CONS. WD,Canandaigua (T),"New Transmission, New Storage, New Pump Station",6300,7570500,25,6160331423
18583,Orange,PINE BUSH WATER DISTRICT,Crawford (T),"Develop new groundwater source, construction of new treatment building and installation of 8,700 ft of water main., New Water Treatment Plant, New Ground Water Source, New Transmission",7000,0,1085,6160331423
18985,Orange,BLOOMING GROVE WD #1-WORLEY HE,South Blooming Grove (V),"Phase 1 Improvements - Two new wells, water main replacement, new pump station, new storage tank, New Ground Water Source, New Storage, New Pump Station, Upgrade Distribution System",1500,7837762,85,6168169185
18188,Orange,GOSHEN VILLAGE,Goshen (V),"Replace WTP at Prospect Reservoir, Upgrade Water Treatment Plant",5676,6120819,75,6174290004
19365,Orange,NEWBURGH (C),Newburgh (C),"Lead Service Line Inventory., Upgrade Distribution System",30000,968000,70,6175258004
18631,Orange,NEWBURGH CITY,Newburgh (C),"Replacement of filter media and installation of SCADA system., Upgrade Water Treatment Plant",28000,0,60,6175258004
18208,Orange,KIRYAS JOEL VILLAGE,Kiryas Joel (V),"Interconnection NYC Aqueduct, Water Filtration Plant, Transmission main. Related to project DWSRF 16906, New Water Treatment Plant, New Transmission, New Inter-Connection",21750,0,55,6175258004
18871,Orange,WALLKILL CONSOLIDATED WD,Wallkill (T),"Upgrade GW Sources and Treatment., Upgrade Water Treatment Plant, Upgrade Ground Water Source, New Ground Water Source",15000,7682997,55,6182941001
19268,Orange,BLOOMING GROVE WD #4-TAPPAN HO,Blooming Grove (T),"New Well, storage tank, disinfection for new well, New Water Treatment Plant, New Ground Water Source, Upgrade Storage",500,2000000,55,6184941001
19370,Orange,WARWICK (V),Warwick (V),"Lead Service Line Inventory, Upgrade Distribution System",6652,575770,45,6185516771
18100,Orange,PAINTED APRON VILLAGE,Painted Apron Water Company,"New Ground Water Source, New Storage, Upgrade Distribution System",150,1000000,45,6186516771
19033,Orange,TUXEDO PARK (V),Tuxedo Park (V),"Clearwell upgrades to increase CT, Upgrade Water Treatment Plant",4600,57800,45,6186574571
19500,Orange,NEW WINDSOR CONSOLIDATED WD,New Windsor (T),"Upgrade Water Treatment Plant, New Water Treatment Plant, New Storage",29500,38000000,40,6224574571
18851,Orange,GREENWOOD LAKE VILLAGE,Greenwood Lake (V),"Village of Greenwood Lake water system improvements., Upgrade Water Treatment Plant, Upgrade Storage, Upgrade Distribution System",3411,5665000,40,6230239571
18656,Orange,FLORIDA VILLAGE,Florida (V),"DBP reduction project., Upgrade Water Treatment Plant",2757,0,40,6230239571
18630,Orange,NEWBURGH CITY,Newburgh (C),"Replacement of water meters throughout the City, Upgrade Distribution System",28000,2982000,40,6233221571
18203,Orange,MIDDLETOWN CITY,Middletown (C),"Upgrade Storage, New Storage",26500,3800000,35,6237021571
18801,Orange,MIDDLETOWN (C),Middletown (C),"Phase 1A - Kinch Pond to Greenville Turnpike Raw Water Main Replacement, Upgrade Transmission",28400,8389500,35,6245411071
18950,Orange,ARROW PARK INC.,Monroe (T),"New well for redundancy, water main replacement, and replacement of the treatment building in-kind, Upgrade Water Treatment Plant, New Ground Water Source, Upgrade Distribution System",83,2740830,30,6248151901
18935,Orange,WARWICK VILLAGE,Warwick (V),"Replace storage tank, new WTP at Well No. 3, New Water Treatment Plant, Upgrade Storage",6083,4277000,25,6252428901
16389,Orange,NEWBURGH CONSOLIDATED WD,Newburgh (T),Upgrade Pump Station,22800,120000,25,6252548901
19175,Orange,MIDDLETOWN CITY,Middletown (C),"Phase 2 - Replacement of main between Shawangunk Reservoir to Monhagen Lake, Upgrade Transmission",26500,41411150,25,6293960051
19041,Orange,WALLKILL CONSOLIDATED WD #1,Wallkill (T),"Rykowski Well Field Expansion and Water Treatment Plant Upgrades, Upgrade Water Treatment Plant, New Ground Water Source",18500,11074560,25,6305034611
18710,Orange,MIDDLETOWN CITY,Middleton (C),Upgrade Distribution System,26500,4600000,25,6309634611
19560,Orange,WALTON LAKE ESTATES WD,Chester (T),"Connection of new well, construction of new well, pump house with treatment, and aged water main replacement, New Water Treatment Plant, New Ground Water Source, Upgrade Distribution System",12574,4450000,20,6314084611
19561,Orange,SUGAR LOAF WD,Chester (T),"Installation of water main on Kings Highway and connection and upgrades to a well and pump house, Upgrade Ground Water Source, Upgrade Distribution System",12574,3090000,20,6317174611
19354,Orange,TUXEDO PARK VILLAGE,Tuxedo Park (V),"Mountain Road Asbestos Water Line Replacement, Upgrade Distribution System",65,1325775,20,6318500386
17346,Orange,WOODBURY CONS. W.D.,Woodbury (T),"Repaint Overlook Storage Tank, Upgrade Storage",10105,218360,20,6318718746
19089,Orange,CHESTER VILLAGE,Chester (V),"Storage and WTP Improvements, Upgrade Water Treatment Plant, Upgrade Storage",3448,1950000,20,6320668746
18267,Orange,CORNWALL-ON-HUDSON,Cornwall (V),"Replacement of existing clearwell liner, Upgrade Storage",9300,196000,20,6320864746
19044,Orange,DENTON HILLS WATER DISTRICT,Wawayanda (T),"Well House Improvements, Upgrade Water Treatment Plant, New Storage",124,1815000,20,6322679746
19016,Orange,CORNWALL-ON-HUDSON,Cornwall-on-Hudson (V),"Mill Street Water Main Replacement, Upgrade Distribution System",9300,231750,15,6322911496
18992,Orange,HARRIMAN VILLAGE,Harriman (V),"New Berwynn Road Booster Pump Station, New Pump Station",4500,526500,15,6323437996
18211,Orange,HIGHLAND FALLS VILLAGE,Highland Falls (V),"Watermain Replacement, Upgrade Distribution System",4400,3700000,15,6327137996
18951,Orange,ORCHARD HILL ESTATES,Monroe (T),"WD 14. Replace ~2300 LF of water main. New well for redundancy., New Ground Water Source, Upgrade Distribution System",196,1951500,15,6329089496
19439,Orange,MONROE (T),Monroe (T),"Lead Service Line Inventory, Upgrade Distribution System",1500,91250,15,6329180746
19386,Orange,NEWBURGH CONSOLIDATED WD,Newburgh (T),"Lead Service Line Inventory, Upgrade Distribution System",23000,374525,15,6329555271
19381,Orange,NEW WINDSOR CONSOLIDATED WD,Cornwall (T),"Lead Service Line Inventory, Upgrade Distribution System",30000,59625,15,6329614896
19378,Orange,WOODBURY CONS. W.D.,Woodbury (V),"Lead Service Line Inventory, Upgrade Distribution System",10105,4894400,15,6334509296
19329,Orange,NEW WINDSOR CONSOLIDATED WD,New Windsor (T),"Lead Service Line Inventory, Upgrade Distribution System",29500,275000,15,6334784296
19255,Orange,MAYBROOK VILLAGE,Maybrook (V),"Prospect Ave Water Storage Tank Replacement, New Storage",3093,1352400,15,6336136696
17290,Orange,WOODBURY CONS. W.D.,Woodbury (T),Upgrade Storage,10105,218360,15,6336355056
17131,Orange,TUXEDO PARK VILLAGE,Tuxedo Park (V),Upgrade Distribution System,1100,263000,15,6336618056
17842,Orange,TUXEDO PARK (V),Tuxedo (V),"Trans-Tuxedo Lake Transmission Line, Upgrade Transmission",1100,757000,15,6337375056
19045,Orange,WOODBURY CONS. W.D.,Woodbury (V),"Trout Brook Well New Raw Water Transmission Main, New Transmission",10105,233600,15,6337608656
19043,Orange,ARLUCK WATER DISTRICT,Wawayanda (T),"Interconnection between Arluck Water District and Denton Hills Water District, New Ground Water Source, New Inter-Connection",118,2634000,15,6340242656
19040,Orange,MONROE WD #8 (SKYVIEW HILLS),Monroe (T),"Water District No. 8 - New Groundwater Source Development, New Ground Water Source",544,2700000,15,6342942656
19030,Orange,NEWBURGH CONSOLIDATED WD,Newburgh (T),"Colden Park Water Main Replacement, Upgrade Distribution System",22800,4946250,15,6347888906
19022,Orange,TUXEDO PARK (V),Tuxedo Park (V),"Town of Tuxedo Master Meter Relocation, Upgrade Distribution System",4600,46400,10,6347935306
19020,Orange,TUDEDO PARK (V),Tuxedo Park (V),"East Village Water Main Replacement, Upgrade Distribution System",1100,1117500,10,6349052806
19021,Orange,TUXEDO PARK (V),Tuxedo Park (V),"Tuxedo Lake Water Main Replacement, Upgrade Distribution System",1100,787000,10,6349839806
19017,Orange,CORNWALL-ON-HUDSON,Cornwall-on-Hudson (V),"Chestnut Street Water Main Replacement, Upgrade Distribution System",9300,247200,10,6350087006
19585,Orange,EASTERN ORANGE COUNTY PIPELINE,Kiryas Joel (V),"Delaware Aqueduct connection, New Transmission",89563,180971000,10,6531058006
19156,Orange,WALLKILL CONSOLIDATED WD,Wallkill (T),"Replacement of outdated meters with smart meters, Upgrade Distribution System",15000,6530052,10,6537588058
17644,Orange,KINGS ESTATES,Warwick Water Corp,"Upgrade distribution system, Upgrade Distribution System",1144,125000,10,6537713058
19028,Orange,MONROE VILLAGE,Monroe (V),"Stage Road Water Main Replacement, Upgrade Distribution System",8892,744700,10,6538457758
19025,Orleans,ALBION VILLAGE,Albion (V),"Phase 2A and 2B WTP Improvements, Upgrade Water Treatment Plant, Upgrade Transmission, Upgrade Storage",6000,7855059,60,6546312817
18759,Orleans,ALBION VILLAGE,Albion (V),"Improvements to the existing WTP, pump station, and replacement of aged transmission main., Upgrade WTP, Upgrade Transmission, Upgrade Pump Station",6000,0,50,6546312817
19540,Orleans,MEDINA (V),Medina (V),"Phase I - Water Main Replacement, SCADA, and Pump Station Improvements, Upgrade Distribution System",6050,12025250,45,6558338067
18414,Orleans,HOLLEY VILLAGE,Holley (V),"Upgrade Storage, Upgrade Distribution System",2150,0,35,6558338067
18612,Orleans,ALBION VILLAGE,Albion (V),"W. Academy and S. Clinton Water Main Improvements, Upgrade Distribution System",6000,900314,35,6559238381
18068,Orleans,WATER IMPROVEMENT BENEFIT AREA #10,Clarendon (T),Extend Distribution System,250,1634949,20,6560873330
18104,Orleans,CARLTON WATER DISTRICT,Carlton (T),Extend Distribution System,2800,2125920,10,6562999250
18351,Oswego,SANDY CREEK WD3/RICHLAND WD 5,Sandy Creek (T),"Consolidates 7 regulated PWSs, Upgrade Ground Water Source, New Transmission, New Distribution System",2600,3000000,1125,6565999250
18376,Oswego,RT 11 NORTH/FULLER RD WD PHASE E,Hastings (T),New Distribution System,1500,0,1095,6565999250
18181,Oswego,ORWELL WD,Orwell (T),"New Source to Address Source Capacity Violation, Upgrade Ground Water Source",150,3027500,155,6569026750
18529,Oswego,ALBION WATER SYSTEM PROJECT,Albion (T),"New Water District & Consolidation of 13 regulated Non-Community PWSs, New System Consolidation, New Water District",1100,12050000,100,6581076750
18817,Oswego,BANKRUPT ROAD WATER DISTRICT,Schroeppel (T),"Bankrupt Road WD and Connection to OCWA, New Distribution System, New Water District",627,5286000,85,6586362750
18910,Oswego,VOLNEY TOWN WD,Volney (T),"County Rt. 6/ Maple Ave Water Service Area Extension, New Distribution System",103,710365,80,6587073115
18818,Oswego,"MT PLEASANT, BATEMAN, DISTIN SERVICE AR",Volney (T),"Mt Pleasant, Bateman, and Distin Roads Water Service Area Extension, New Distribution System",280,1356000,80,6588429115
18010,Oswego,TOWN/VILLAGE JOINT WATER PROJECT,Parish (T),"Water Supply Area No. 1. Serve inadequate private wells, Extend Distribution System, New Water District",1200,9476000,80,6597905115
18932,Oswego,COUNTY RT. 57/ HUNTLEY RD WATER DISTRICT,Schroeppel (T),"County Route 57/ Huntley Road Water District, New Distribution System",253,2879571,60,6600784686
18930,Oswego,WATER SERVICE AREA #6,Mexico (T),"Provide public water to Water Service Area #6, New Distribution System",479,549170,60,6601333856
18282,Oswego,CLEVELAND VILLAGE,Cleveland (V),"Storage & Transmission Upgrades, New Ground Water Source, Upgrade Storage, Upgrade Distribution System",925,0,60,6601333856
19515,Oswego,OSWEGO (C),Oswego (C),"Ellen St. and Gardiner Hill HSZ Interconnect, and rehab Gardiner Hill Tank, Upgrade Storage, Upgrade Distribution System",1700,11200000,55,6612533856
19188,Oswego,TOWN OF CONSTANTIA WD NO. 3,Constantia (T),"Water District 3 formation w/ new DI mains, valves, and services, New Water District",140,3230080,55,6615763936
19533,Oswego,PARISH (V),Parish (V),"New Village Municipal Water System, New Water District",534,13047010,50,6628810946
18428,Oswego,OSWEGO CITY,Oswego (C),"McCaffrey WTP Upgrades, Upgrade Water Treatment Plant",29400,750000,50,6629560946
18087,Oswego,PULASKI VILLAGE,Pulaski (V),Upgrade Distribution System,2398,18849810,45,6648410756
18928,Oswego,VILLAGE OF PULASKI WATER SYSTEM,Pulaski (V),"Replacement of aged and deteriorating water main, Upgrade Distribution System",900,11962000,40,6660372756
18285,Oswego,PULASKI VILLAGE,Pulaski (V),Upgrade Distribution System,2398,300000,40,6660672756
19123,Oswego,MEXICO (V),Mexico (V),"Phase 2 Distribution Main Replacement and Source Upgrades, Upgrade Ground Water Source, Upgrade Distribution System",1085,12000000,30,6672672756
18237,Oswego,MEXICO VILLAGE,Mexico (V),"Replacement of old and undersized water main, Upgrade Distribution System",1600,725000,20,6673397756
17987,Otsego,SOUTHSIDE WATER DISTRICT NO. 6,Oneonta (T),"Southside Water District No. 6, New Ground Water Source, New Complete System (New System), New Storage, New Distribution System",1569,0,1140,6673397756
17976,Otsego,SOUTHSIDE WATER DISTRICT NO. 5,Oneonta (T),"Southside Water District No. 5, New Ground Water Source, New Complete System (New System), New Storage, New Distribution System",1570,0,1135,6673397756
18846,Otsego,RICHFIELD SPRINGS (V),Richfield Springs (V),"Address SWTR Compliance and DBPs, SCADA/electrical upgrades, Distribution replacement and looping, Upgrade Water Treatment Plant, New Pump Station, New Distribution System",1500,20680000,200,6694077756
17093,Otsego,HARTWICK WATER DISTRICT,Hartwick (T),"New Ground Water Source, Upgrade Storage, Upgrade Distribution System",416,3760078,95,6697837834
18197,Otsego,ONEONTA CITY,Oneonta (C),"WTP, Distribution, and Storage Upgrades, Upgrade Water Treatment Plant, New Storage",15779,8072625,85,6705910459
18958,Otsego,VILLAGE OF OTEGO,Otego (V),"GW Source Development, WTP Resiliency, AC Pipe Replacement, Booster Station Replacement, Upgrade Water Treatment Plant, New Ground Water Source, Upgrade Distribution System",1010,6899315,65,6712809774
18814,Otsego,EDMESTON (T),Edmeston (T),"Treatment and Distribution System Improvements, Upgrade Water Treatment Plant, Upgrade Distribution System",900,9647000,55,6722456774
19153,Otsego,ONEONTA CITY,Oneonta (C),"Distribution and Storage Improvements, Upgrade Storage, Upgrade Distribution System",15779,12525830,45,6734982604
19433,Otsego,ONEONTA (C),Oneonta (C),"Lead service line inventory, Upgrade Distribution System",16000,1200000,40,6736182604
19444,Otsego,EDMESTON (T),Edmeston (T),"Lead service line inventory, Upgrade Distribution System",900,359200,30,6736541804
19496,Putnam,STARR RIDGE MANOR,Southeast (T),"Installation of GAC treatment system to address PFAS contamination, Upgrade Water Treatment Plant",295,2000000,55,6738541804
19495,Putnam,BIRCH HILL ACRES,Southeast (T),"Installation of GAC treatment system to address PFAS contamination, Upgrade Water Treatment Plant",60,1200000,55,6739741804
19568,Putnam,KENT WD NO. 1 AND 2,Kent (T),"Installation of Ion Exchange to remove PFAS and replacement of two wells and a storage tank, Upgrade Water Treatment Plant, Upgrade Ground Water Source, Upgrade Storage",636,2482300,55,6742224104
19566,Putnam,COLD SPRING (V),Cold Spring (V),"Phillipstown Upper Dam Rehabilitation, Upgrade Surface Water Source",2800,7749000,5,6749973104
18584,Rensselaer,BERLIN WATER DISTRICT #2,Berlin (T),"Replace Storage, Upgrade Well Pumps and System Controls, Upgrade Ground Water Source, Upgrade Storage",700,0,1070,6749973104
18354,Rensselaer,HOOSICK FALLS (V) PWS,Hoosick Falls (V),"Village Water System Extension to Town Phase 1 - NYS Rt 22 North & South, New Pump Station, Upgrade Distribution System, Extend Distribution System, New System Consolidation",4000,5510500,110,6755483604
18364,Rensselaer,HOOSICK FALLS (V) PWS,Hoosick Falls (V),"Village Water System Extension to Town Phase 6 - NYS Rt. 7/Hoosac School/Hill Road, Extend Distribution System, New System Consolidation",4000,4532000,100,6760015604
18362,Rensselaer,HOOSICK FALLS (V) PWS,Hoosick Falls (V),"Village Water System Extension to Town Phase 4 - NYS Rt 67 East & West, Upgrade Distribution System, Extend Distribution System",4000,4655600,95,6764671204
19567,Rensselaer,TROY (C),Troy (C),"Corrosion Control Treatment Optimization, Upgrade Water Treatment Plant",51400,16070000,80,6780741204
19287,Rensselaer,TROY (C),Troy (C),"Lead service line inventory, Upgrade Distribution System",51400,572000,70,6781313204
19110,Rensselaer,POESTENKILL WD #2,Poestenkill (T),"Creation of Poestenkill WD #2 to provide water to an area with PFAS contamination, New Water District",700,5711000,70,6787024204
18812,Rensselaer,BATTISTI WATER DISTRICT NO. 10,Schodack (T),"Batisti WD No. 10, Upgrade Distribution System, New System Consolidation, New Water District",130,2432000,60,6789456204
17867,Rensselaer,TROY CITY PWS,Troy (C),"Replace raw water transmission mains between Tomhannock and Troy WTP, Upgrade Transmission",49170,0,55,6789456204
18585,Rensselaer,PETERSBURGH WATER DISTRICT,Petersburgh (T),"Address PFAS, Develop Additional GW Source, Storage and Distribution Improvements, Upgrade Water Treatment Plant, New Ground Water Source, Upgrade Storage, Upgrade Distribution System",240,0,55,6789456204
18995,Rensselaer,TROY (C) PWS,Troy (C),"Phase 2 (North Section) RW Transmission Main, Upgrade Transmission",51400,2000000,55,6791456204
19120,Rensselaer,SCHODACK HIGHWAY GARAGE WATER DISTRICT,Schodack (T),"Installation of new watermain and 500,000-gallon water storage tank on Route 9, New Storage, New Distribution System",150,10300000,40,6801756204
19108,Rensselaer,HOOSICK FALLS (V),Hoosick Falls (V),"Rogers Ave Tank Rehab, Upgrade Storage, Upgrade Distribution System",4500,7000000,40,6808756204
19534,Rensselaer,RENSSELAER (C),Rensselaer (C),"Cross Street Pump Station Rehabilitation, Upgrade Water Treatment Plant, Upgrade Pump Station",9800,2199600,35,6810955804
18030,Rensselaer,RENSSELAER CITY PWS,Rensselaer (C),"Washington Ave Corridor Improvements, Upgrade Distribution System",7500,3169952,35,6814125756
19138,Rensselaer,RENSSELAER CITY PWS,Rensselaer (C),"Lead Service Line Replacement, Upgrade Distribution System",7500,420000,30,6814545756
19141,Rensselaer,RENSSELAER CITY PWS,Rensselaer (C),"Washington Avenue Main Replacement, Upgrade Distribution System",7500,3219551,25,6817765307
16334,Rensselaer,HOOSICK FALLS (V) PWS,Hoosick Falls (V),Upgrade Distribution System,4000,569000,20,6818334307
16292,Rensselaer,BRUNSWICK WATER SYSTEM,Brunswick (T),"New Water Treatment Plant, Upgrade Distribution System",10000,2896500,20,6821230807
19383,Rensselaer,EAST GREENBUSH (T),East Greenbush (T),"Cross Street Pump Station Rehabilitation, Upgrade Water Treatment Plant, Upgrade Pump Station",21000,2199600,20,6823430407
18190,Rensselaer,NASSAU (V) PWS,Nassau (V),"Replace water mains on Rt. 20., Upgrade Distribution System",1250,669000,15,6824099407
18959,Rensselaer,NASSAU (V) PWS,Nassau (V),Upgrade Distribution System,1250,721000,10,6824820407
18942,Rockland,SUFFERN VILLAGE,Suffern (V),"PFAS Removal, Upgrade Water Treatment Plant",12000,532800,80,6825353207
19171,Rockland,NYACK VILLAGE WATER SUPPLY,Nyack (V),"PFAS Treatment at Nyack Water Plant, New Other Expenses, New Other (OT)",14700,4749320,65,6830102527
19479,Rockland,SUFFERN (V),Suffern (V),"Iron and Manganese Filtration System Rehab, Upgrade Water Treatment Plant",11441,1944228,20,6832046755
18944,Rockland,SUFFERN (V),Suffern (V),"Standby Generator Installation at wellfield and Bon Aire Pump Station, Upgrade Transmission",11000,936548,10,6832983303
18943,Rockland,SUFFERN (V),Suffern (V),"Water meter replacement, Upgrade Distribution System",11000,2275004,10,6835258307
18577,Saratoga,MECHANICVILLE CITY,Mechanicville (C),"Filtration Upgrades, Upgrade Water Treatment Plant",5100,100000,1095,6835358307
18524,Saratoga,MALTAVILLE WATER DISTRICT,Malta (T),"Maltaville WD., New Water District",450,3636724,70,6838995031
18332,Saratoga,SOUTH GLENS FALLS VILLAGE,South Glens Falls (V),"Rehabilitate Storage Tank; New GAC for PFOA/PFOS Removal., Upgrade Storage, Upgrade Distribution System",3700,2000000,50,6840995031
19588,Saratoga,CORINTH (V),Corinth (V),"Replace/Repair WTP Pumps, Replace water main along Main St, Hill Ave and Heath Ave, Upgrade Water Treatment Plant, Upgrade Distribution System",3000,14996000,45,6855991031
19555,Saratoga,SCHUYLERVILLE-VICTORY WATER BOARD,Schuylerville-Victory WB,"Joint Water System Improvements, Upgrade Water Treatment Plant, Upgrade Distribution System",2200,9187900,45,6865178931
19264,Saratoga,BALLSTON SPA WATER SYSTEM,Ballston Spa (V),"2022 Infrastructure Improvements, Upgrade Storage, Upgrade Pump Station, Upgrade Distribution System",5399,14068000,30,6879246931
19490,Saratoga,SARATOGA SPRINGS (C),Saratoga Springs (C),"Loughberry Dam Reservoir Intake Rehab project, Upgrade Other Expenses, Upgrade Surface Water Source, Upgrade Other (OT)",28301,8396329,25,6887643260
18866,Saratoga,SARATOGA COUNTY WATER AUTHORITY,Saratoga County WA,"Cordero Blvd New Storage and Controls., New Storage",100000,10000000,25,6897643260
19491,Saratoga,SARATOGA SPRINGS (C),Saratoga Springs (C),"Clinton Street Watermain replacement. , Upgrade Distribution System",5466,1323000,15,6898966260
18552,Saratoga,STILLWATER WD NO. 6,Stillwater (T),"Replacing infrastructure West Street and Micklas Street, Upgrade Distribution System",192,748850,15,6899715110
18705,Saratoga,STILLWATER WD NO. 6,Stillwater (T),"Replacing infrastructure East, Ferris, Lefko Streets & Best , Champlain Avenues, Upgrade Distribution System",114,752250,15,6900467360
19503,Saratoga,STILLWATER (V),Stillwater (V),"Hudson Ave Water Main Replacement, Upgrade Distribution System",1572,2878850,10,6903346210
16510,Schenectady,DELANSON (V),Delanson (V),"Address Stage 2 DBPR Violation., Upgrade Water Treatment Plant",335,1767425,90,6905113635
18979,Schenectady,SCHENECTADY CITY WATER WORKS,Schenectady (C),"Phase 1 Rice Road Source and WTP Improvements,, New Ground Water Source",61821,7775470,50,6912889105
18123,Schenectady,GLENVILLE WD #11,Glenville (T),"New Well #5., New Ground Water Source",15000,851604,45,6913740709
18444,Schenectady,SCOTIA VILLAGE WATER WORKS,Scotia (V),"Water System Improvements., Upgrade Ground Water Source, Upgrade Storage, Upgrade Distribution System",9500,3000000,45,6916740709
19450,Schenectady,SCHENECTDAY (C),Schenectady (C),"Lead service line inventory., Upgrade Distribution System",62000,636025,40,6917376734
19273,Schenectady,SCHENECTADY (C),Schenectady (C),"Phase 2 Rice Road WTP Improvements., Upgrade Water Treatment Plant",60000,7581212,40,6924957946
19259,Schenectady,ROTTERDAM (T),Rotterdam (T),"WD #5 High Priority Improvements., New Ground Water Source, Upgrade Distribution System",30523,34917000,40,6959874946
18868,Schenectady,GLENVILLE WD #11,Glenville (T),"Upgrade WTP, rehab Lolik Lane Tanks #1 & #2, and Distribution. , Upgrade Water Treatment Plant, Upgrade Storage, Upgrade Distribution System",15000,25729561,25,6985604507
18447,Schenectady,PRINCETOWN WATER SUPPLY,Princetown (T),"Replacement of corroded distribution system components, Upgrade Distribution System",600,1214500,10,6986819007
17504,Schoharie,CENTRAL BRIDGE WATER DISTRICT,Central Bridge WD,"Upgrade water treatment plant for DBP control and organics removal., Upgrade Water Treatment Plant, Upgrade Distribution System",1061,0,1160,6986819007
17572,Schoharie,SHARON SPRINGS VILLAGE,Sharon Springs (V),"Water system improvements., Upgrade Water Treatment Plant, Upgrade Ground Water Source, Upgrade Storage, Upgrade Distribution System",547,450000,1125,6987269007
17787,Schoharie,SCHOHARIE VILLAGE,Schoharie (V),"Water System Improvements., Upgrade Water Treatment Plant, Upgrade Storage, New Pump Station, Upgrade Distribution System",1030,0,50,6987269007
18934,Schoharie,COBLESKILL WATER DISTRICT,Cobleskill (T),"Extension of Cobleskill (V) to Cobleskill (T) WD #2, Extend Distribution System",20,535600,30,6987804607
18811,Schuyler,WATKINS GLEN VILLAGE,Watkins Glen (V),"Water System Improvements. Address CT and Turbidity Issues, Upgrade Water Treatment Plant, Upgrade Storage, Upgrade Distribution System",2149,0,1145,6987804607
19102,Schuyler,ODESSA VILLAGE,Odessa (V),"Treatment Plant for iron, manganese, and arsenic; Water Main replacement; Tank mixer, New Water Treatment Plant, Upgrade Storage, Upgrade Distribution System",810,10251410,115,6998056017
18815,Schuyler,MONTOUR FALLS,Montour Falls (V),"Replace Aged Undersized Distribution Mains., Upgrade Distribution System",1800,4685856,40,7002741873
18214,Seneca,WATERLOO VILLAGE,Waterloo (V),"WTP, Distribution, and Storage Improvements., Upgrade Water Treatment Plant, Upgrade Storage, Upgrade Inter-Connection",7000,0,1115,7002741873
18127,Seneca,INTERLAKEN VILLAGE,Interlaken (V),"Upgrade Ground Water Source, Upgrade Storage, Upgrade Distribution System",650,0,1105,7002741873
19196,Seneca,SENECA FALLS (T),Seneca Falls (T),"Water Main Replacement and Extension & WTP Upgrades, Upgrade Water Treatment Plant, Extend Distribution System, Upgrade Distribution System",9000,67514000,105,7070255873
19571,Seneca,OVID (V),Ovid (V),"New UF and RO systems, tank mixing and ventilation systems, replacement of water main. , New Other Expenses, New Water Treatment Plant, Upgrade Distribution System, New Other (OT)",1056,4438167,90,7074694040
19335,Seneca,SENECA FALLS (T),Seneca Falls (T),"Phase 1 of overall #19196 Project - WTP Upgrades and WM Extension, Upgrade Water Treatment Plant",9027,23500000,85,7098194040
15283,Seneca,TOWN OF LODI WATER SYSTEM,Lodi (T),"New Water System to Serve (T) & (V) Lodi., New Complete System (New System)",395,11795722,80,7109989762
19544,Seneca,TOWN OF FAYETTE WD NO. 8,Fayette (T),"WD No. 8 Phase 2, Extend Distribution System",450,1854000,60,7111843762
18854,Seneca,WILLARD WD,Romulus (T),"Willard WD Distribution Improvements., Upgrade Distribution System",372,1264602,40,7113108364
19410,Seneca,SENECA FALLS (T),Seneca Falls (T),"Lead Service Line Inventory., Upgrade Distribution System",9000,1088710,35,7114197074
19293,Seneca,WATERLOO (V),Waterloo (V),"Lead Service Line Inventory., Upgrade Distribution System",4924,502310,25,7114699384
19151,St. Lawrence,MORRISTOWN VILLAGE,Morristown (T),"WTP & Distribution Improvements. River Road East Corridor Extension., New Water Treatment Plant, Upgrade Storage, Upgrade Distribution System, New Water District",490,16789000,140,7131488384
18939,St. Lawrence,HERMON VILLAGE,Hermon (T),"Source and WTP improvements, and replacement of entire distribution system for WD #1., Upgrade Water Treatment Plant, New Ground Water Source, New Transmission, New Distribution System",492,7879500,90,7139367884
18199,St. Lawrence,COOK STREET WD,Norfolk (T),Extend Distribution System,300,1122000,70,7140489884
19145,St. Lawrence,MASSENA (T),Massena (T),"Proposed Service Area No. 1, New Water District",350,9270000,70,7149759884
18704,St. Lawrence,POTSDAM (T),Potsdam (T),"NYS Rt. 56 WD., New Distribution System, New Water District",305,4802752,70,7154562636
18889,St. Lawrence,TOWN OF PITCAIRN WATER DISTRICT,Pitcairn (T),"Extension to serve properties with contaminated wells, New Distribution System",60,4232000,65,7158794636
18234,St. Lawrence,MASSENA VILLAGE,Massena (T),"East Massena WD Improvements., Upgrade Distribution System",11209,3055500,45,7161850136
19514,St. Lawrence,TOWN OF EDWARDS WD NO.1,Edwards (T),"Well No.2 Improvements, Upgrade Surface Water Source",465,800000,45,7162650136
18703,St. Lawrence,LOUISVILLE WD #4,Louisville (T),"New Water District #4., New Distribution System",350,5960000,45,7168610136
19473,St. Lawrence,OGDENSBURG (C),Ogdensburg (C),"Lead service line inventory., Upgrade Distribution System",10064,2688300,40,7171298436
19468,St. Lawrence,MORRISTOWN (T),Morristown (T),"Lead service line inventory., Upgrade Distribution System",500,24864,40,7171323300
19462,St. Lawrence,GOUVERNEUR (T),Gouverneur (T),"Lead service line inventory., Upgrade Distribution System",800,32747,40,7171356047
18940,St. Lawrence,EAST LOUISVILLE WATER DISTRICT,Louisville (T),"WTP Upgrade., Upgrade Water Treatment Plant, New Water Treatment Plant",1200,2082625,40,7173438672
19457,St. Lawrence,DE KALB JUNCTION WD,De Kalb (T),"Lead service line inventory., New Distribution System",315,20081,40,7173458753
19455,St. Lawrence,CLIFTON (T),Clifton (T),"Lead service line inventory., Upgrade Distribution System",232,20128,40,7173478881
19447,St. Lawrence,POTSDAM (V),Potsdam (V),"Lead service line inventory., Upgrade Distribution System",8312,1077380,40,7174556261
19543,St. Lawrence,WADDINGTON (V),Waddington (V),"Main St. and St. Lawrence Ave. Waterline Replacement, Upgrade Distribution System",937,1930709,35,7176486970
19523,St. Lawrence,OGDENSBURG (C),Ogdensburg (C),"East David St. Infrastructure Replacement Project, Upgrade Distribution System",30,1926100,35,7178413070
19518,St. Lawrence,CANTON (V),Canton (V),"Transmission Main Upgrades and Water Storage Tank Replacement, Upgrade Transmission, Upgrade Storage",6314,17841238,35,7196254308
19463,St. Lawrence,HEUVELTON (V),Heuvelton (V),"Lead service line inventory., Upgrade Distribution System",659,32747,35,7196287055
19460,St. Lawrence,STAR LAKE WD,Fine (T),"Lead service line inventory., Upgrade Distribution System",1300,48419,35,7196335474
18937,St. Lawrence,POTSDAM VILLAGE,Potsdam (V),"Elm Street Water main replacement., Upgrade Distribution System",9425,1116000,35,7197451474
18530,St. Lawrence,GOUVERNEUR EAST SIDE WATER DISTRICT,Gouverneur (T),"Replacement of distribution main along US Route 11, Upgrade Distribution System",165,1141600,35,7198593074
18517,St. Lawrence,MADRID WATER DISTRICT,Madrid (T),Upgrade Storage,800,1327155,35,7199920229
19459,St. Lawrence,EDWARDS (T),Edwards (T),"Lead service line inventory., Upgrade Distribution System",400,20138,30,7199940366
19465,St. Lawrence,LISBON WD,Lisbon (T),"Lead service line inventory., Upgrade Distribution System",300,14494,20,7199954860
18768,Steuben,CAMPBELL WATER DISTRICT,Campbell (T),"WD #1 Extension., New Ground Water Source, New System Consolidation",280,0,1115,7199954860
18002,Steuben,HAMLET OF WOODHULL MUNICIPAL WS,Woodhull (T),"System to serve former Village (now hamlet) with private contaminated wells., New Ground Water Source, New Storage, New Distribution System",483,4489928,75,7204444788
18016,Steuben,WD #3,Campbell (T),"Serve private contaminated/poor yielding wells., Extend Water District",1025,908687,70,7205353475
18516,Steuben,GREENWOOD WATER DISTRICT,Greenwood (T),"New Fe/Mn Removal Treatment., New Water Treatment Plant, Upgrade Storage",330,856356,60,7206209831
19574,Steuben,PRATTSBURGH WD,Prattsburgh (T),"Water distribution system improvements , Upgrade Other Expenses, Upgrade Storage, Upgrade Distribution System, Upgrade Other (OT)",594,7107000,55,7213316831
15902,Steuben,ADDISON VILLAGE,Addison (V),"Main replacement & looping, new High Street Tank, wellhouse VFD improvements, Upgrade Ground Water Source, Upgrade Storage, Upgrade Distribution System",1797,1690000,55,7215006831
19243,Steuben,COHOCTON (T),Cohocton (T),"Tank rehab, distribution upgrades and looping, well house improvements, Upgrade Ground Water Source, Upgrade Storage, Upgrade Distribution System",485,3759150,55,7218765981
18565,Steuben,CANISTEO VILLAGE,Canisteo (V),"Replace critical sections of the water main within the Village's distribution system, and upgrades to storage tank and meters., Upgrade Storage, Upgrade Distribution System",2320,0,50,7218765981
19432,Steuben,BATH (V),Bath (V),"Mt. Washington tank, Maple Heights tank, and low-priority main replacements, Upgrade Storage, Upgrade Distribution System",5500,8500000,50,7227265981
18820,Steuben,BATH (V),Bath (V),"W. Washington, Liberty, Geneva, W. Morris St, E Steuben Distribution Improvements, Upgrade Distribution System",5500,11834000,50,7239099981
17974,Steuben,SOUTH CORNING VILLAGE,South Corning (V),"Upgrade Storage, Upgrade Distribution System",1147,0,45,7239099981
18908,Steuben,HORNELL (C),Hornell (C),"Transmission main replacement., Upgrade Transmission",9592,2375000,40,7241474981
19385,Steuben,BATH (V),Bath (V),"Lead service line replacement., Upgrade Distribution System",5432,1561000,40,7243035981
19384,Steuben,BATH (V),Bath (V),"Lead Service Line Inventory, Upgrade Distribution System",5432,1382000,40,7244417981
18762,Steuben,AVOCA VILLAGE,Avoca (V),"Replacement of meters., Upgrade Other Expenses, Upgrade Other (OT)",970,152500,35,7244570481
18863,Steuben,PAINTED POST VILLAGE,Painted Post (V),"Well upgrades and replacement of storage tank, Upgrade Ground Water Source, Upgrade Storage",1842,2409517,30,7246979998
18861,Steuben,MORNINGSIDE HEIGHTS WD,Erwin (T),"Improvements to the WTP and security., Upgrade Water Treatment Plant",4570,688452,20,7247668450
18973,Suffolk,RIVERHEAD WD,Riverhead (T),"WD Extension - Forge Rd MHPs due to PFOA/PFOS and Mn contamination in private wells, Extend Distribution System, Extend Water District",28000,1185000,110,7248853450
19312,Suffolk,SUFFOLK COUNTY WATER AUTHORITY,Suffolk County Water Authority,"Water main extension to 64 homes with PFAS contaminated private wells along Old Country Road Area, Extend Distribution System",1009264,2479267,85,7251332717
19476,Suffolk,SUFFOLK COUNTY WATER AUTHORITY,Suffolk County Water Authority,"New AOP system at South Spur Drive well field., New Water Treatment Plant",20048,3000000,80,7254332717
19332,Suffolk,RIVERHEAD WD,Riverhead (T),"Well No. 5-1 PFAS removal, Upgrade Water Treatment Plant",28000,2200000,80,7256532717
19088,Suffolk,SOUTH HUNTINGTON WD,South Huntington WD,"Plant No. 8 - AOP treatment for 1,4-dioxane removal, Upgrade Water Treatment Plant",81760,9098504,80,7265631221
19104,Suffolk,SUFFOLK COUNTY WATER AUTHORITY,SCWA,"Connection of public water to residences in Calverton, Town of Brookhaven along South River road due to PFAS detection in private wells, Upgrade Distribution System",1009264,6850000,60,7272481221
16069,Suffolk,RIVERHEAD WD,Riverhead (T),"Construction of Replacement Production Well, Upgrade Water Treatment Plant, Upgrade Ground Water Source",28000,2754000,50,7275235221
18972,Suffolk,RIVERHEAD WD,Riverhead (T),"WD Extension Nos. 95 & 96 - Calverton. Extend Public Water to Address PFAS in Private Residential Wells, Extend Distribution System",190,10549704,45,7285784925
18971,Suffolk,RIVERHEAD WD,Riverhead (T),"WD Extensions - Manorville (Ext #94) due to MTBE, PFOA, PFOS, and Fe/Mn contamination in private wells, Extend Distribution System",28000,12877000,45,7298661925
18882,Suffolk,SUFFOLK COUNTY WATER AUTHORITY,Suffolk Co. Water Authority,"Connection of private wells to public water system in Manorville in the Town of Riverhead, Extend Distribution System",1009264,9494261,45,7308156186
19591,Suffolk,RIVERHEAD WATER DISTRICT,Riverhead (T),"Well No. 5-2A PFAS removal, Upgrade Water Treatment Plant",190,2327800,40,7310483986
19001,Suffolk,DIX HILLS WD,Dix Hills WD,"Plant No. 8 - AOP treatment for 1,4-dioxane removal, Upgrade Water Treatment Plant",34522,5017750,40,7315501736
19306,Suffolk,SUFFOLK COUNTY WATER AUTHORITY,Suffolk County Water Authority,"Kings Park Road Well Field AOP, Upgrade Water Treatment Plant",36536,1500000,40,7317001736
19294,Suffolk,SUFFOLK COUNTY WATER AUTHORITY,Suffolk County Water Authority,"Hawkins Road Well Field AOP, Upgrade Water Treatment Plant",1009264,1500000,40,7318501736
19477,Suffolk,SUFFOLK COUNTY WATER AUTHORITY,Suffolk County Water Authority,"New AOP system at Montauk Point State Blvd well field., New Water Treatment Plant",4318,3000000,40,7321501736
19361,Suffolk,SUFFOLK COUNTY WATER AUTHORITY,Suffolk County Water Authority,"Wheeler Road Well No. 4 - AOP, Upgrade Water Treatment Plant",1009264,1500000,40,7323001736
19339,Suffolk,DIX HILLS WATER DISTRICT,Dix Hills Water District,"Wellhead GAC treatment for Plant No. 7., New Water Treatment Plant",41000,8227000,40,7331228736
19309,Suffolk,SUFFOLK COUNTY WATER AUTHORITY,Suffolk County Water Authority,"Reservoir Ave Wells 1A & 2 - AOP, Upgrade Water Treatment Plant",1009264,3000000,40,7334228736
19305,Suffolk,SUFFOLK COUNTY WATER AUTHORITY,Suffolk County Water Authority,"Jennings Road Well Field AOP, Upgrade Water Treatment Plant",3665,4500000,40,7338728736
19303,Suffolk,SUFFOLK COUNTY WATER AUTHORITY,Suffolk County Water Authority,"Horseblock Road Well 1 - AOP, Upgrade Water Treatment Plant",1009264,1500000,40,7340228736
19302,Suffolk,SUFFOLK COUNTY WATER AUTHORITY,Suffolk County Water Authority,"Oxhead Road Well Field AOP, Upgrade Water Treatment Plant",1009264,1500000,40,7341728736
19301,Suffolk,SUFFOLK COUNTY WATER AUTHORITY,Suffolk County Water Authority,"North Washington Avenue Well Field AOP, Upgrade Water Treatment Plant",1009264,1500000,40,7343228736
19299,Suffolk,SUFFOLK COUNTY WATER AUTHORITY,Suffolk County Water Authority,"Montauk Point State Boulevard Well Field AOP, Upgrade Water Treatment Plant",1009264,3000000,40,7346228736
19298,Suffolk,SUFFOLK COUNTY WATER AUTHORITY,Suffolk County Water Authority,"Albany Avenue Well No. 2 AOP, Upgrade Water Treatment Plant",1009264,1500000,40,7347728736
19297,Suffolk,SUFFOLK COUNTY WATER AUTHORITY,Suffolk County Water Authority,"Wicks Path Well 1 - AOP, Upgrade Water Treatment Plant",1009264,1500000,40,7349228736
19296,Suffolk,SUFFOLK COUNTY WATER AUTHORITY,Suffolk County Water Authority,"Ruth Boulevard Well Field AOP, Upgrade Water Treatment Plant",1009264,3000000,40,7352228736
19295,Suffolk,SUFFOLK COUNTY WATER AUTHORITY,Suffolk County Water Authority,"Mill Lane Well Field AOP, Upgrade Water Treatment Plant",2468,1500000,40,7353728736
19291,Suffolk,SUFFOLK COUNTY WATER AUTHORITY,Suffolk County Water Authority,"Cornell Drive Well Field AOP, Upgrade Water Treatment Plant",36536,1500000,40,7355228736
18742,Suffolk,SUFFOLK COUNTY WATER AUTHORITY,Suffolk County Water Authority,"Reservoir Avenue Well Field New AOP, Upgrade Water Treatment Plant",1009264,1500000,40,7356728736
19000,Suffolk,GREENLAWN WD,Greenlawn WD,"Well No. 8 - AOP treatment for 1,4-dioxane removal, Upgrade Water Treatment Plant",42000,5546550,40,7362275286
19029,Suffolk,SOUTH HUNTINGTON WD,South Huntington WD,"Plant No. 4 - AOP/GAC treatment for 1,4-Dioxane and PFOA/PFOS removal, Upgrade Water Treatment Plant",81760,7236150,40,7369511436
18880,Suffolk,SUFFOLK COUNTY WATER AUTHORITY,SCWA,"North Fork Transmission Main - Southold, Extend Distribution System",1009264,27489708,25,7397001144
18798,Suffolk,HAMPTON BAYS WD,Hampton Bays WD,"Iron and Manganese removal at Plant No. 4, Upgrade Water Treatment Plant",12500,3600000,25,7400601144
19160,Suffolk,SUFFOLK COUNTY WATER AUTHORITY,SCWA,"Replacement of Well No. 1A at the Adams Avenue Well Field, Upgrade Ground Water Source",1009264,1200000,25,7401801144
19144,Suffolk,WEST NECK WATER SUPPLY,Shelter Island (T),"New Ground Water Source, Upgrade Distribution System",100,2250928,25,7404052072
19002,Suffolk,DIX HILLS WD,Dix Hills WD,"Rehabilitation at Plant No. 3 including replacement of well pumps and chemical system, Upgrade Water Treatment Plant",34522,4634000,20,7408686072
18591,Suffolk,SALTAIRE (V),Saltaire (V),"Replace approximately 9,800 linear feet of water main, Upgrade Distribution System",2500,6421020,15,7415107092
18881,Suffolk,SUFFOLK COUNTY WATER AUTHORITY,Suffolk Co. Water Authority,"Construction of 2-MG storage tank at Town Line Road well field, New Storage",1009264,4678000,15,7419785092
19275,Suffolk,RIVERHEAD WATER DISTRICT,Riverhead (T),"New Ground Storage Tank at East Wind Drive, New Storage",35000,7427500,15,7427212592
19142,Suffolk,SUFFOLK COUNTY WATER AUTHORITY,SCWA,"Replacement of Well No. 3A at the Oval Drive Well Field, Upgrade Ground Water Source",3315,1200000,15,7428412592
19139,Suffolk,SUFFOLK COUNTY WATER AUTHORITY,SCWA,"Replacement of Well No. 2A at the Oval Drive Well Field, Upgrade Ground Water Source",3315,1200000,15,7429612592
19135,Suffolk,SUFFOLK COUNTY WATER AUTHORITY,SCWA,"Replacement of Aging Production Well No. 1A at the Falcon Drive Well Field, Upgrade Ground Water Source",1009264,1200000,15,7430812592
19034,Suffolk,RIVERHEAD WD,Riverhead (T),"Old Country Road Tank Rehabilitation, Upgrade Storage",28000,3645500,15,7434458092
18462,Suffolk,GREENLAWN WD,Greenlawn Water District,"Distribution Main Replacement, Upgrade Distribution System",42000,2077675,10,7436535767
19314,Suffolk,GREENLAWN WD,Greenlawn Water District,"Elmo Place New Well No. 19, New Ground Water Source",42000,3072000,10,7439607767
18398,Suffolk,SUFFOLK COUNTY WATER AUTHORITY,Suffolk Co. Water Authority,Upgrade Distribution System,1009264,2897841,10,7442505608
15856,Suffolk,DIX HILLS WD,Huntington (T),"Double containment - above ground caustic soda tanks - plants #1, 4, 6, 7, 8, 9, 10, Upgrade Ground Water Source",34522,411600,10,7442917208
19148,Suffolk,SUFFOLK COUNTY WATER AUTHORITY,SCWA,"Replacement of 10,000 feet of water main., Upgrade Distribution System",34878,3427391,10,7446344599
17560,Sullivan,THE CALLICOON WATER COMPANY INC,Delaware (T),"Upgrade Water Treatment Plant, Upgrade Ground Water Source",854,0,1180,7446344599
19266,Sullivan,WOODRIDGE VILLAGE,Woodridge (V),"Installation of storage tank, new membrane filter, rehab lagoon, Upgrade Water Treatment Plant, New Storage, Upgrade Distribution System",902,16200000,70,7462544599
18835,Sullivan,NARROWSBURG WD,Tusten (T),"System-wide Infrastructure Upgrades., Upgrade Storage, Upgrade Distribution System",500,7635000,60,7470179599
18797,Sullivan,MELODY LAKE ACRES,Thompson (T),"Well No. 1 Upgrades and Replace storage tank, chlorination and corrosion control systems., Upgrade Water Treatment Plant",150,725000,60,7470904599
18827,Sullivan,WHITE SULPHUR SPRINGS WD,Liberty (T),"Upgrade Ground Water Source, Upgrade Distribution System",500,857681,45,7471762280
19414,Sullivan,FALLSBURG WHO-LS-SF,Fallsburg (T),"Old Falls Water Tank Replacement, Upgrade Storage",8355,2494148,40,7474256428
19366,Sullivan,WOODRIDGE (V),Woodridge (V),"Lead Service Line Inventory, Upgrade Distribution System",747,256470,40,7474512898
18042,Sullivan,LIBERTY VILLAGE,Liberty (V),New Storage,4800,975000,40,7475487898
18526,Sullivan,JEFFERSONVILLE VILLAGE,Village of Jeffersonville,"New Transmission, New Storage, Upgrade Distribution System",554,4552976,35,7480040874
18838,Sullivan,FALLSBURG WHO-LS-SF,Fallsburg (T),"Water main replacement - NYS Route 42 and County Hwy 53., Upgrade Distribution System",8355,2413538,35,7482454412
19573,Sullivan,WURTSBORO (V),Wurtsboro (V),"Pennsylvania Ave and 1st St Well House Improvements, Upgrade Water Treatment Plant, Upgrade Ground Water Source",1265,1647200,30,7484101612
18885,Sullivan,YOUNGSVILLE WD,Callicoon (T),"Replace 125,000-gal storage tank, New Storage",300,1436228,30,7485537840
18618,Tioga,CANDOR VILLAGE WATER DEPT.,Candor (V),"Source, treatment and distribution improvements., Upgrade Ground Water Source, Upgrade Pump Station, Upgrade Distribution System",1020,0,1070,7485537840
18026,Tioga,CANDOR VILLAGE WATER DEPT.,Candor (V),"Upgrade Storage, Upgrade Distribution System",1020,3047237,45,7488585077
18613,Tioga,OWEGO WD #2 & #3,Owego (T),"Crestview Well House and Rt 434 Transmission Main Improvements., New Ground Water Source, Upgrade Transmission",4904,2425341,25,7491010418
19186,Tompkins,TRUMANSBURG (V),Trumansburg (V),"Village-Wide Storage, Treatment, and Pump Station Upgrades, Upgrade Water Treatment Plant, Upgrade Storage, Upgrade Pump Station",2300,3884000,45,7494894418
18839,Tompkins,NEWFIELD WATER DISTRICT,Newfield (T),"Phase 1 - Replacement of aged and undersized asbestos water main along Main Street & New GW Source, New Ground Water Source, Upgrade Distribution System",2300,6470136,35,7501364554
18836,Tompkins,DRYDEN WD,Dryden (T),"Route 366 / Hamlet of Varna Water Main Replacement., Upgrade Distribution System",725,3588518,35,7504953072
18073,Tompkins,WEST DANBY WD,Danbury(T),New Storage,265,384600,20,7505337672
19348,Tompkins,BOLTON POINT WATER SYSTEM,Cayuga Heights (V),"Lead Service Line Replacement, Upgrade Distribution System",3600,540377,15,7505878049
19347,Tompkins,BOLTON POINT WATER SYSTEM,Cayuga Heights (V),"Lead Service Line Inventory, Upgrade Distribution System",3600,345951,15,7506224000
18660,Ulster,ELLENVILLE (VILLAGE) WATER DIS,Ellenville (V),"Phase 2 of #15003 - New Well - replace GWUDI wells & other Improvements, New Ground Water Source, Upgrade Storage, Upgrade Distribution System",4323,2800000,2215,7509024000
18700,Ulster,ROSENDALE WATER DISTRICT,Rosendale (T),"Phase 2 of project 18111. Cost overrun., Upgrade Surface Water Treatment Rule Compliance Facility, New Ground Water Source, Upgrade Storage, Upgrade Distribution System",2200,2070000,2150,7511094000
15616,Ulster,PORT EWEN WATER DISTRICT,Esopus (T),New Storage,4800,0,55,7511094000
18058,Ulster,KINGSTON (CITY) WATER DISTRICT,City of Kingston Water Dep.,"Replacement of Mink Hollow Raw Water Intake, Upgrade Other Expenses, Upgrade Other (OT)",24000,0,50,7511094000
18507,Ulster,KINGSTON (CITY) WATER DISTRICT,Kingston (C),"Phase 2 transmission main and SCADA rehabilitation, Upgrade Transmission, Upgrade Distribution System",24000,0,45,7511094000
19396,Ulster,NEW PALTZ (V),New Paltz (V),"Lead Service Line Inventory., Upgrade Distribution System",7324,193125,40,7511287125
18779,Ulster,KINGSTON (CITY) WATER DISTRICT,Kingston (C),"Cooper Lake Dam/Reservoir rehabilitation, Upgrade Other Expenses, Upgrade Transmission, Upgrade Storage, Upgrade Other (OT)",24000,0,40,7511287125
18999,Ulster,NEW PALTZ (VILLAGE) WATER DIST,New Paltz (V),"Phase 2 Water System Upgrades, Upgrade Distribution System",5600,2841300,35,7514128425
19279,Ulster,PORT EWEN WD,Esopus (T),"Emergency interconnection infrastructure, WTP electrical updates, Water Main Replacement, Upgrade Water Treatment Plant, Upgrade Distribution System, New Inter-Connection",4500,3099200,30,7517227625
18744,Ulster,PORT EWEN WATER DISTRICT,Esopus (T),"Port Ewen WD upgrades to water treatment pland and distribution system infrastructure, Upgrade Water Treatment Plant, Upgrade Distribution System",4800,0,30,7517227625
19037,Ulster,ULSTER WATER DISTRICT,Ulster (T),"0.45 MG Storage Tank Replacement, Upgrade Storage",5500,1876660,25,7519104285
19265,Ulster,HIGHLAND WATER DISTRICT,Lloyd (T),"Upgrades to filter equipment, pumps, etc at filtration plant, Upgrade Water Treatment Plant",4000,8837400,20,7527941685
19390,Ulster,PORT EWEN WD,Esopus (T),"Lead Service Line Inventory, Upgrade Distribution System",4500,228000,15,7528169685
19394,Ulster,NEW PALTZ WD,New Paltz (T),"Lead Service Line Inventory., Upgrade Distribution System",1775,90125,15,7528259810
19364,Ulster,HIGHLAND WATER DISTRICT,Lloyd (T),"Water storage tank replacement at Highland Water Treatment Facility, Upgrade Storage",4000,2645000,15,7530904810
18119,Ulster,HERITAGE ESTATES WT CO,Heritage Estates Homeowners,Upgrade Storage,80,25000,15,7530929810
19169,Ulster,WALLKILL WATER DISTRICT,Shawangunk (T),"New GW Source, Disinfection, and Distribution for Wallkill Water district., New Ground Water Source, New Distribution System",1680,1699500,15,7532629310
18751,Warren,NORTH CREEK WATER DISTRICT,Johnsburg (T),"New Storage tank to replace South Tank and Distribution System Upgrades., New Storage, Upgrade Pump Station, Upgrade Distribution System",1000,0,60,7532629310
19262,Warren,CHESTERTOWN WD,Chester (T),"New well, upgrade distribution system, replace AC pipe, New Ground Water Source, Upgrade Distribution System",750,2947000,50,7535576310
19493,Warren,QUEENSBURY WATER DISTRICT,Queensbury (T),"Extension to Jenkinsville to serve private wells contaminated with 1,4-Dioxane., New Distribution System",425,6760920,45,7542337230
18975,Warren,GLENS FALLS CITY,Glens Falls (C),"Water Filtration Plant filter repairs., Upgrade Water Treatment Plant",13000,1864650,35,7544201880
18593,Warren,WARRENSBURG WATER DISTRICT,Warrensburg (T),"Replacement of the water storage tank transmission main., New Transmission",3600,0,35,7544201880
19513,Warren,DIAMOND POINT WD,Lake George (T),"Replacement of Aged Water Main, Upgrade Distribution System",495,1485260,30,7545687140
18431,Warren,LAKE LUZERNE (T),Lake Luzerne (T),"Rehabilitate existing water storage tank and replace water mains., Upgrade Storage, Upgrade Distribution System",2500,2573000,30,7548260140
18426,Warren,GLENS FALLS (C),Glens Falls (C),"Replacement of aged water main, Upgrade Distribution System",1184,30426200,30,7578686340
19263,Warren,BOLTON WATER DISTRICT,Bolton (T),"Phase II Water System Improvements., Upgrade Other Expenses, Upgrade Storage, Upgrade Distribution System, Upgrade Other (OT)",1800,3670920,30,7582357260
19449,Warren,LAKE LUZERNE (T),Lake Luzerne (T),"Lead service line inventory., Upgrade Distribution System",2500,650342,25,7583007602
18427,Warren,POTTERSVILLE WATER DISTRICT,Chester (T),Upgrade Ground Water Source,325,521230,25,7583528832
19522,Warren,BOLTON (T),Bolton (T),"Rehabilitation of Edgecomb Pond Dam, Upgrade Surface Water Source",1800,2165575,20,7585694407
18837,Warren,QUEENSBURY WATER DISTRICT,Queensbury (T),"Ridge Road Water Main Improvements., Upgrade Distribution System",21200,1415000,10,7587109407
18575,Washington,GREENWICH VILLAGE,Greenwich (V),"Mn Treatment, Replace Existing Wells, Replace Transm Main, Water Metering., Upgrade Water Treatment Plant, New Ground Water Source, Upgrade Transmission, Upgrade Distribution System",2000,5200000,1105,7592309407
18877,Washington,NORTH GRANVILLE WD #1,Granville (T),"Source development and distribution improvements for the North Granville WD., Upgrade Ground Water Source, Upgrade Distribution System",800,2825625,70,7595135032
18458,Washington,FORT EDWARD VILLAGE,Fort Edward (V),"Hill Storage Tank Replacement and Upgrade PS and Distribution., New Storage, Upgrade Pump Station, Upgrade Distribution System",3150,0,45,7595135032
19035,Washington,FORT ANN (V),Fort Ann (V),"Halfway Brook Transmission Main Replacement, Upgrade Transmission",460,313120,40,7595448152
18977,Washington,WHITEHALL VILLAGE,Whitehall (V),"Replace old water distribution system., Upgrade Distribution System",2800,5145000,35,7600593152
18553,Washington,HUDSON FALLS VILLAGE (QUEENSBURY),Hudson Falls (V),"Replacement of Water Mains in School Street Neighbrhood., Upgrade Distribution System",7419,787950,30,7601381102
18970,Washington,HUDSON FALLS VILLAGE (QUEENSBURY),Hudson Falls (V),"WM Replacement on Beech, Willow, and Williams Streets., Upgrade Distribution System",7419,840000,25,7602221102
19215,Wayne,NEWARK VILLAGE,Newark (V),"New 4.0 MG storage tank to replace Allerton Reservoir, New Storage",9682,6164550,80,7608385652
19211,Wayne,WOLCOTT (V),Wolcott (V),"Village of Wolcott WTP Upgrades, Upgrade Water Treatment Plant",2465,8400000,60,7616785652
19232,Wayne,CLYDE (V),Clyde (V),"New vertical turbine pumps, new well houses, treatment improvements, emergency backup power, Upgrade Water Treatment Plant, Upgrade Ground Water Source",2269,1659000,55,7618444652
18070,Wayne,CLYDE VILLAGE,Clyde (V),Upgrade Transmission,2269,357900,45,7618802552
18177,Wayne,ROSE - NORTH ROSE WD,Rose (T),Upgrade Ground Water Source,1950,1427000,40,7620229552
18925,Wayne,CLYDE (V),Clyde (V),"Main replacement on Glasgow St., Upgrade Distribution System",226,2950000,35,7623179552
18899,Wayne,LYONS (T),Lyons (T),"Replace approx. 23,000-LF of water main and appurtenances., Upgrade Distribution System",5500,14332625,30,7637512177
19197,Wayne,ROSE (T),Rose (T),"Catchpole Wellfield Upgrades to address Fe/Mn and Sulfide, Upgrade Water Treatment Plant",1950,2141780,30,7639653957
18902,Wayne,MARION (T),Marion (T),"Interconnections to improve water system efficiency., Upgrade Distribution System",1000,3647200,20,7643301157
18892,Wayne,WCW&SA,Wayne County W&SA,"(T) Macedon & (T) Marion Water Main Replacement., Upgrade Distribution System",500,4037000,20,7647338157
18891,Wayne,WCW&SA,Wayne County W&SA,"East Side Water Main Extension., Extend Distribution System",150,3450700,20,7650788857
19198,Wayne,WILLIAMSON (T),Williamson (T),"Bennett St. Area Watermain Replacement, Upgrade Distribution System",6757,3090000,20,7653878857
17488,Westchester,WESTCHESTER JOINT WATER WORKS,WJWW,"Phase 1a of Project #18654 and #18269. Construction of 30 MGD filter plant, New Surface Water Treatment Rule Compliance Facility",55210,55000000,125,7708878857
18269,Westchester,WESTCHESTER JOINT WATER WORKS,WJWW,"Phase 2 of #18654 & #17488, New Surface Water Treatment Rule Compliance Facility",55210,83000000,125,7791878857
18954,Westchester,SOMERS HAMLET WD,Somers (T),"New drinking water distribution system to address PFAS contamination, New Distribution System, New Water District",100,2912700,110,7794791557
19475,Westchester,WHITE PLAINS (C),White Plains (C),"New Orchard Street WTP, New Water Treatment Plant",56000,32000000,75,7826791557
19105,Westchester,MEADOWS AT CROSS RIVER,Meadow Water-Works Corp.,"Removal of sodium chloride and PFAS from water system, Upgrade Water Treatment Plant",630,952750,70,7827744307
19049,Westchester,KENSICO WATER DISTRICT,Mount Pleasant (T),"Kensico WD Storage Tank and Treatment Improvements, Upgrade Storage, Upgrade Distribution System",17452,9221695,65,7836966002
18893,Westchester,OAKRIDGE WATER DISTRICT,Lewisboro (T),"Addition of GAC for PFAS removal., Upgrade Water Treatment Plant",892,2000000,60,7838966002
19481,Westchester,SUNSET RIDGE WD,North Salem (T),"New ion exchange treatment system for PFOS/PFOA removal, Upgrade Water Treatment Plant",570,91696,55,7839057698
19577,Westchester,YONKERS (C),Yonkers (C),"Hillview Entry Point Disinfection Facility, New Water Treatment Plant",110000,30000000,45,7869057698
18789,Westchester,MOUNT KISCO WATER DEPARTMENT,Mount Kisco (V),"Upgrade Water Treatment Plant, Upgrade Ground Water Source, Upgrade Distribution System",9600,8400000,40,7877457698
19091,Westchester,PEEKSKILL CITY,Peekskill (C),"Storage Tank and Water Main Replacement, Upgrade Water Treatment Plant, Upgrade Storage, Upgrade Distribution System",22400,5000000,40,7882457698
18946,Westchester,GREENBURGH CONSOLIDATED WD #1,Greenburgh (T),"New chlorine contact tank and chemical feed building at the Knollwood Pump Station; add second connection to Shaft 20, Upgrade Transmission, Upgrade Pump Station",38489,20274144,35,7902731842
19570,Westchester,PEEKSKILL (C),Peekskill (C),"Camp Field Reservoir dredging, Lower Wiccopee Dam spillway modifications, and water main replacement, Upgrade Surface Water Source, Upgrade Distribution System",25514,8166000,30,7910897842
19367,Westchester,PEEKSKILL (C),Peekskill (C),"Lead Service Line Inventory, Upgrade Distribution System",24075,1465690,30,7912363532
18503,Westchester,WESTCHESTER JOINT WATER WORKS,WJWW,Upgrade Pump Station,55210,3300000,25,7915663532
18496,Westchester,GREENBURGH CONSOLIDATED WD #1,Greenburg (T),"Rumbrook-Knollwood CWD Interconnection, New Inter-Connection",38489,12119500,25,7927783032
18933,Westchester,YONKERS CITY,Yonkers (C),"Construction of CT compliance monitoring facilities, New Surface Water Treatment Rule Compliance Facility",196086,1250000,20,7929033032
18931,Westchester,YONKERS CITY,Yonkers (C),"Replacement of Hillview Phosphoric Acid storage tanks, Upgrade Water Treatment Plant",196086,310000,20,7929343032
19360,Westchester,TARRYTOWN WATER SUPPLY,Tarrytown (V),Upgrade Pump Station,11000,250000,20,7929593032
19336,Westchester,YONKERS BUREAU OF WATER,Yonkers (C),"Lead Service Line Inventory., Upgrade Distribution System",211569,3115750,20,7932708782
15220,Westchester,CROTON FALLS WATER DISTRICT,North Salem (T),"Installation of new well (Well No. 7)., New Ground Water Source",175,303215,20,7933011997
18048,Westchester,YONKERS CITY,Yonkers (C),"Nepperhan Ave redundant transmission main, Upgrade Distribution System",196086,5342189,20,7938354186
18957,Westchester,AMAWALK-SHENOROCK WATER DIST.,Somers (T),Upgrade Storage,3800,577830,15,7938932016
18952,Westchester,AMAWALK-SHENOROCK WATER DIST.,Somers (T),Upgrade Distribution System,3800,1993514,15,7940925530
18945,Westchester,GREENBURGH CONSOLIDATED WD #1,Greenburgh (T),"Fairview Tank Replacement, Upgrade Storage",38489,7810000,15,7948735530
19416,Westchester,NEW CASTLE/STANWOOD W.D.,New Castle (T),"Bedford Road Pump Station Upgrades, Upgrade Pump Station",16800,1006516,15,7949742046
19388,Westchester,OSSINING WATER DEPARTMENT,Ossining (V),"Lead Service Line Inventory, Upgrade Distribution System",32000,134000,15,7949876046
19373,Westchester,OSSINING WATER DEPARTMENT,Ossining (V),"Lead Service Line Replacement, Upgrade Distribution System",30000,3441000,15,7953317046
19346,Westchester,WESTCHESTER COUNTY WD #3,Westchester County,"Water Tower Rehabilitation, Upgrade Storage",6000,6781000,15,7960098046
15407,Westchester,MOUNT KISCO WATER DEPARTMENT,Mount Kisco (V),"Upgrade Metered Interconnections w/Town of New Castle, Upgrade Distribution System",9600,343608,15,7960441654
19344,Westchester,LARCHMONT (V),Larchmont (V),"Lead Service Line Inventory, Upgrade Distribution System",6630,2510728,15,7962952382
18457,Westchester,CORTLANDT CONSOLIDATED WD,Cortlandt (T),"Asbestos Cement Pipe Replacement, Upgrade Distribution System",28369,2800000,15,7965752382
19270,Westchester,COUNTY WATER DISTRICT #1,Westchester County,"Rehab Shaft 22 and Kensico Dam Chlorination Facility, Upgrade Other Expenses, Upgrade Other (OT)",363274,6674400,15,7972426782
19178,Westchester,YONKERS CITY,Yonkers (C),"Replace 30"" water main under Saw Mill River Pkwy, Upgrade Distribution System",196086,4321880,15,7976748662
19019,Westchester,OSSINING WATER DEPARTMENT,Ossining (T),"North State Road Water Main Replacement, Upgrade Distribution System",30000,5170611,10,7981919273
19557,Westchester,NEW CASTLE/STANWOOD CONSOLIDATED WD,New Castle (T),"Water main replacement on Quaker Street, Upgrade Distribution System",1590,13604800,10,7995524073
19350,Westchester,TARRYTOWN WATER SUPPLY,Tarrytown (V),"Phase VIIIA water main replacement, New Distribution System",11000,3301500,10,7998825573
18502,Westchester,TARRYTOWN WATER SUPPLY,Tarrytown (V),"Phase VII water main replacement, Upgrade Distribution System",11000,2610000,10,8001435573
19161,Westchester,COUNTY WATER DISTRICT #1,Westchester County,"Connection to NYC's Distribution System by extending KBP, Extend Transmission",363274,96284400,10,8097719973
18382,Westchester,YORKTOWN CONSOLIDATED WATER DIST. #1,Yorktown (T),"Watermain Cleaning and Lining., Upgrade Distribution System",36000,2473550,10,8100193523
18793,Westchester,IRVINGTON WATER SUPPLY,Irvington (V),"Replacement of approximately 800 feet of distribution main, Upgrade Distribution System",6631,589300,10,8100782823
19185,Westchester,SCARSDALE WATER DEPARTMENT,Scarsdale (V),"Rehabilitation of CI Main via Cement lining, Upgrade Distribution System",20883,3533500,10,8104316323
19164,Westchester,COUNTY WATER DISTRICT #1,Westchester County,"Rehabilitate 71,000 LF of the Kensico Bronx Pipeline, Upgrade Distribution System",363274,25307100,10,8129623423
19415,Westchester,NEW CASTLE/STANWOOD W.D.,New Castle (T),"Millwood WTP Roof Replacement, Upgrade Water Treatment Plant",16800,2683400,5,8132306823
18956,Westchester,LINCOLNDALE WD,Somers (T),New Distribution System,1100,16641504,5,8148948327
19242,Wyoming,GARDEAU WATER DISTRICT,Castile (T),"Gardeau WD main replacement and district extension, Upgrade Distribution System, Extend Water District",60,2755250,115,8151703577
19061,Wyoming,ATTICA VILLAGE,Attica (V),"Water Treatment Plant Upgrades, Upgrade Water Treatment Plant",2700,11125000,100,8162828577
18898,Wyoming,PERRY VILLAGE,Perry (V),"WTP upgrade to Address DBPs, Upgrade Water Treatment Plant, Upgrade Transmission, Upgrade Storage",3945,7200000,95,8170028577
19548,Wyoming,TOWN OF PERRY WD NO. 2,Perry (T),"New WD No. 2, Upgrade Distribution System",215,6360734,60,8176389311
18906,Wyoming,ARCADE VILLAGE,Arcade (V),"Hamlet of Sandusky Water System Improvements, Upgrade Storage, Upgrade Distribution System",2400,4617490,50,8181006801
18406,Wyoming,WARSAW VILLAGE,Warsaw (V),"Upgrade Water Treatment Plant, Upgrade Distribution System",3850,4988250,45,8185995051
19539,Wyoming,SHELDON VARYSBURG WD,Sheldon Varysburg WD,"WM Replacement, Improvement of Tanks and Well Sites, Upgrade Distribution System",350,2697570,30,8188692621
18761,Wyoming,WARSAW TOWN WATER DISTRICT,Warsaw (T),"WD No. 1 WM Replacement Saltvale Rd., Upgrade Distribution System",185,1257000,30,8189949621
18242,Yates,DRESDEN VILLAGE,Dresden (V),"THM removal aeration equipment and flushing hydrants, Upgrade Storage",700,0,1085,8189949621
19194,Yates,TOWN OF TORREY WATER DISTRICT NO.1,Torrey (T),"New Water District No.1, New Water District",202,3727000,65,8193676621
19206,Yates,YATES COUNTY,Yates County,"Route 14A Corridor Water Supply, New Water District",400,7647750,60,8201324371
19205,Yates,YATES COUNTY,Yates County,"Route 14 Corridor Water Supply, New Water District",2000,30591000,60,8231915371
19192,Yates,WATER DISTRICT NO. 5,Benton (T),"New Water District No.5, New Water District",39,1144000,60,8233059371
19519,Yates,PENN YAN (V),Penn Yan (V),"Upgrades to WTP to improve water quality and system reliability, Upgrade Water Treatment Plant, Upgrade Storage",8159,5610000,50,8238669371
19193,Yates,TOWN OF BENTON WATER DISTRICT NO.6,Benton (T),"New Water District No.6, New Water District",450,26889000,50,8265558371
19406,Yates,DUNDEE (V),Dundee (V),"Lead Service Line Inventory, Upgrade Distribution System",1690,545000,40,8266103371
18858,Yates,DRESDEN (V),Dresden (V),"System wide replacement of aged mains and appurtenances, Upgrade Distribution System",600,7146006,40,8273249377
18383,Yates,MIDDLESEX WD,Middlesex (T),Upgrade Distribution System,480,825625,25,8274075002
19569,Yates,JERUSALEM (T),Jerusalem (T),"Watermain replacement in Keuka Park/Central Avenue water district, Upgrade Distribution System",1152,1313054,15,8275388056